,id,Tweet_Date,Tweet_Text,Favorite_Count,Retweet_Count,Popular_Sum,Date
0,1057695407344541697,Wed Oct 31 18:06:50 +0000 2018,"RT @elonmusk: @rarelyserious @Tesla For those unfamiliar, this uses Tesla Autopark/Summon. Slightly smarter version hopefully ready soon. B…",0,401,401,2018-10-31
1,1057690425710891009,Wed Oct 31 17:47:03 +0000 2018,"@rarelyserious @Tesla For those unfamiliar, this uses Tesla Autopark/Summon. Slightly smarter version hopefully rea… https://t.co/UmyNY1IFq1",3193,401,3594,2018-10-31
2,1057688156315693057,Wed Oct 31 17:38:02 +0000 2018,@rarelyserious @Tesla Cool haha,6717,259,6976,2018-10-31
3,1057030946594029569,Mon Oct 29 22:06:31 +0000 2018,"Legally required officers of a corporation are president, treasurer &amp; secretary. Guess I have to keep 1st one or it… https://t.co/kcZ5ouFwAy",34785,1297,36082,2018-10-29
4,1057025309688520704,Mon Oct 29 21:44:07 +0000 2018,"@FredericLambert Good point, might put that one back",2387,43,2430,2018-10-29
5,1057010155332628481,Mon Oct 29 20:43:53 +0000 2018,Deleted my Tesla titles last week to see what would happen. I’m now the Nothing of Tesla. Seems fine so far.,133112,10056,143168,2018-10-29
6,1056031369480962048,Sat Oct 27 03:54:33 +0000 2018,@SnazzyQ @FredericLambert Signing off Twitter for a few days ...,2603,118,2721,2018-10-27
7,1056030239610925056,Sat Oct 27 03:50:03 +0000 2018,"@SnazzyQ @FredericLambert Don’t worry, we’ll make it right",1545,40,1585,2018-10-27
8,1056028956124561408,Sat Oct 27 03:44:57 +0000 2018,@CGasparino @Tesla The FOIA on this will be solid gold. Can’t wait.,1172,57,1229,2018-10-27
9,1056027905807941632,Sat Oct 27 03:40:47 +0000 2018,@Model3Owners Not going up. We will just offer those who ordered bought 3P either $5k back or free lifetime Supercharging.,4093,182,4275,2018-10-27
10,1056026765502513152,Sat Oct 27 03:36:15 +0000 2018,@Lindowitz @FredericLambert It’s a reasonable criticism. We wanted to make the awesome version of Model 3 Performan… https://t.co/gEZnBI90jB,1272,44,1316,2018-10-27
11,1056025766599651328,Sat Oct 27 03:32:17 +0000 2018,"@CGasparino @Tesla Exactly, this is total bs. What part of “production hell” sounds like a sure thing!?",5197,240,5437,2018-10-27
12,1056025320397037570,Sat Oct 27 03:30:31 +0000 2018,@sk2sno @rtk86 @sheldonth @FactsDataTruth @Tesla We will enable track mode for all performance cars,885,41,926,2018-10-27
13,1056025032617426945,Sat Oct 27 03:29:22 +0000 2018,"@FredericLambert It was underpriced. Anyway, if you want $5k refund &amp; free Supercharging turned off, we will do that.",1281,46,1327,2018-10-27
14,1056024539832844288,Sat Oct 27 03:27:24 +0000 2018,"@rtk86 @sheldonth @FactsDataTruth @Tesla Ok, we will turn off lifetime free Supercharging and give you $5k refund",803,25,828,2018-10-27
15,1056024270076239873,Sat Oct 27 03:26:20 +0000 2018,"@ctgm @FredericLambert Yeah, or free lifetime Supercharging, whichever you prefer",622,19,641,2018-10-27
16,1056023407907659783,Sat Oct 27 03:22:55 +0000 2018,@FredericLambert Didn’t you get free Supercharging for life? Current buyers don’t get that.,1445,41,1486,2018-10-27
17,1056017653758738432,Sat Oct 27 03:00:03 +0000 2018,@annerajb @FredericLambert @pjj_knowles @yames51 @DigitalDunzey Exactly. That’s Monday.,876,30,906,2018-10-27
18,1056014996860166145,Sat Oct 27 02:49:29 +0000 2018,@officialjaden Yes. Will require tapping indicator to confirm at first. When safety looks good after 10M miles of d… https://t.co/cfUeaHyQ3I,9934,431,10365,2018-10-27
19,1056012930423160832,Sat Oct 27 02:41:17 +0000 2018,"@pjj_knowles @yames51 @DigitalDunzey No, but I will",1200,34,1234,2018-10-27
20,1056012650918727681,Sat Oct 27 02:40:10 +0000 2018,@mangeHDbackup Isn’t it obvious?,547,15,562,2018-10-27
21,1056012218897059841,Sat Oct 27 02:38:27 +0000 2018,@yames51 @DigitalDunzey Worth it,3117,251,3368,2018-10-27
22,1056012001606914048,Sat Oct 27 02:37:35 +0000 2018,@vincent13031925 @cleantechnica @CNBC @businessinsider @business @WSJ @Teslarati @InsideEVs True,1468,47,1515,2018-10-27
23,1056001102385049601,Sat Oct 27 01:54:17 +0000 2018,Tesla Autopilot Drive on Navigation going to wide release in North America tonight,53149,4177,57326,2018-10-27
24,1056000474560659456,Sat Oct 27 01:51:47 +0000 2018,@sheldonth @FactsDataTruth @Tesla Not exactly. We just bundled the upgrade package into Performance. No problem if… https://t.co/8n10Hl2dP1,685,30,715,2018-10-27
25,1055999636236685312,Sat Oct 27 01:48:27 +0000 2018,@fb1975 @DigitalDunzey Haha,877,19,896,2018-10-27
26,1055999003299471360,Sat Oct 27 01:45:56 +0000 2018,"@DigitalDunzey On Insta, 10% of followers like even lame posts. On Twitter, good posts get 1%.",2262,96,2358,2018-10-27
27,1055996774572154880,Sat Oct 27 01:37:05 +0000 2018,@_Akhaten @nichegamer @raissabontempo @SomeGrayAreas @reddit @Twitter Lacks scale,501,11,512,2018-10-27
28,1055996020474036224,Sat Oct 27 01:34:05 +0000 2018,"@nichegamer @raissabontempo @SomeGrayAreas @reddit @Twitter Reddit is massive, but def has gems",1974,42,2016,2018-10-27
29,1055993647995412481,Sat Oct 27 01:24:39 +0000 2018,"@SomeGrayAreas @reddit @Twitter Reddit’s twitter account is lame, because it’s not real Reddit",2981,71,3052,2018-10-27
30,1055991876879233024,Sat Oct 27 01:17:37 +0000 2018,@Mcgillligan Exactly,1924,40,1964,2018-10-27
31,1055991558174953472,Sat Oct 27 01:16:21 +0000 2018,@FactsDataTruth @Tesla You’re right. Earlier Model 3 Performance buyers got free lifetime Supercharging. Will add t… https://t.co/GKKXM8dScD,697,34,731,2018-10-27
32,1055990004738977793,Sat Oct 27 01:10:11 +0000 2018,"On Twitter, likes are rare &amp; criticism is brutal. So hardcore. It’s great.",170785,16501,187286,2018-10-27
33,1055958732599783425,Fri Oct 26 23:05:55 +0000 2018,"Glad you’re ok @tylerthecreator 
https://t.co/ie4yBMw0tW",56628,7292,63920,2018-10-26
34,1055942429013041153,Fri Oct 26 22:01:08 +0000 2018,"@PopularEthics @Tesla S is better, but rear seat folds down in Model 3, so bikes can fit in trunk",647,16,663,2018-10-26
35,1055909450987450368,Fri Oct 26 19:50:05 +0000 2018,@scr00chy @mcjamez @Tesla Hey that’s my Halloween costume!,1530,66,1596,2018-10-26
36,1055899741551095808,Fri Oct 26 19:11:30 +0000 2018,@bosterogriego @Tesla @mayemusk @WSJ Good question,4939,285,5224,2018-10-26
37,1055882299756109824,Fri Oct 26 18:02:12 +0000 2018,"@mcjamez @Tesla Clearly, you’re not reading my twitter",2552,174,2726,2018-10-26
38,1055882032679542784,Fri Oct 26 18:01:08 +0000 2018,@Eifiea @ianelantzy @SEC_Enforcement I wish,985,39,1024,2018-10-26
39,1055874116803158016,Fri Oct 26 17:29:41 +0000 2018,@rstefani11 @Tesla Taking action. Tesla body shops now operating in California aiming for same day body repair in most cases.,7370,189,7559,2018-10-26
40,1055873366337347584,Fri Oct 26 17:26:42 +0000 2018,"RT @Tesla: Tesla Safety Update
https://t.co/8DpSDLiqNw",0,682,682,2018-10-26
41,1055864213585809408,Fri Oct 26 16:50:20 +0000 2018,@Zorbrix @JamesLandino Yes Zorbix,2172,42,2214,2018-10-26
42,1055862869760237569,Fri Oct 26 16:44:59 +0000 2018,"@ianelantzy @SEC_Enforcement Sir, I would never …",1472,70,1542,2018-10-26
43,1055690934384381953,Fri Oct 26 05:21:47 +0000 2018,"@CateLuvsLondon Yes, I am a little girl. Ok, not that little. Or a girl.",2765,350,3115,2018-10-26
44,1055689809367199744,Fri Oct 26 05:17:18 +0000 2018,Making progress …,35738,1716,37454,2018-10-26
45,1055689369535692801,Fri Oct 26 05:15:34 +0000 2018,I said dankest not darkest omg,135620,12936,148556,2018-10-26
46,1055653541317042177,Fri Oct 26 02:53:12 +0000 2018,@JamesLandino im actually cat girl here’s selfie rn https://t.co/2h4WeuwepE,65927,22905,88832,2018-10-26
47,1055651447428116480,Fri Oct 26 02:44:52 +0000 2018,@JamesLandino It’s pretty hot,11980,927,12907,2018-10-26
48,1055631532444934144,Fri Oct 26 01:25:44 +0000 2018,"Deep down, I think Frost secretly preferred the latter",16180,435,16615,2018-10-26
49,1055612813635280896,Fri Oct 26 00:11:21 +0000 2018,@ElDuderinoGG Ok,1462,98,1560,2018-10-26
50,1055612158216552449,Fri Oct 26 00:08:45 +0000 2018,Fire and Ice https://t.co/ulgSZ1wlPl,36343,4179,40522,2018-10-26
51,1055607883595886592,Thu Oct 25 23:51:46 +0000 2018,"Flies like an arrow, but fruit flies like a banana",53411,5165,58576,2018-10-25
52,1055606159715971072,Thu Oct 25 23:44:55 +0000 2018,@NewYorker Love the Concorde,4878,172,5050,2018-10-25
53,1055604614265860101,Thu Oct 25 23:38:46 +0000 2018,@SwiftOnSecurity Bound to happen,2656,131,2787,2018-10-25
54,1055601434337497088,Thu Oct 25 23:26:08 +0000 2018,@Gounther_ Yes,1580,54,1634,2018-10-25
55,1055600140730347520,Thu Oct 25 23:21:00 +0000 2018,Time,64345,7095,71440,2018-10-25
56,1055595089328726016,Thu Oct 25 23:00:55 +0000 2018,"RT @elonmusk: @Model3Owners Love Tesla supporters so much!!♥️♥️♥️♥️♥️♥️♥️♥️
♥️       ♥️♥️♥️        ♥️
                ♥️♥️…",0,1075,1075,2018-10-25
57,1055592321654243328,Thu Oct 25 22:49:56 +0000 2018,"@Model3Owners Love Tesla supporters so much!!♥️♥️♥️♥️♥️♥️♥️♥️
♥️       ♥️♥️♥️        ♥️
                ♥️♥️… https://t.co/qmJQ8hwzps",20243,1075,21318,2018-10-25
58,1055589758536081408,Thu Oct 25 22:39:45 +0000 2018,@pewdiepie Midnight,40691,2713,43404,2018-10-25
59,1055585815718322178,Thu Oct 25 22:24:04 +0000 2018,My twitter feed rn https://t.co/48Ay7CxR56,82155,7245,89400,2018-10-25
60,1055570196222509056,Thu Oct 25 21:22:00 +0000 2018,@EndyO_ Then the hell with science!,2021,105,2126,2018-10-25
61,1055568956625285120,Thu Oct 25 21:17:05 +0000 2018,Not moths tho,111508,9525,121033,2018-10-25
62,1055560318930235392,Thu Oct 25 20:42:46 +0000 2018,RT @cleantechnica: Tesla Powerwall Keeps A Remote Home Powered Through 42-Hour Utility Outage https://t.co/G8IQs2XllX https://t.co/ALME33iD…,0,867,867,2018-10-25
63,1055517521082609664,Thu Oct 25 17:52:42 +0000 2018,Send me ur dankest memes!!,335521,72577,408098,2018-10-25
64,1055516972866166784,Thu Oct 25 17:50:31 +0000 2018,🐻 in 🧠,19593,999,20592,2018-10-25
65,1055515363335561216,Thu Oct 25 17:44:07 +0000 2018,Fresh puro from my meme dealer https://t.co/EdU5uJVVne,103435,16994,120429,2018-10-25
66,1055501230875668480,Thu Oct 25 16:47:58 +0000 2018,@pmcollins @cleantechnica Exactly. There are many states where we are not allowed to sell cars at all or are severe… https://t.co/KBbkJgTnNN,1506,92,1598,2018-10-25
67,1055500063785463808,Thu Oct 25 16:43:20 +0000 2018,"@cleantechnica Model 3 was top-selling car in US by revenue despite no advertising, no paid endorsements &amp; no disco… https://t.co/TnEpLUqNEi",22118,2749,24867,2018-10-25
68,1055362206798307328,Thu Oct 25 07:35:32 +0000 2018,Massive thanks to Tesla owners &amp; supporters. We wouldn’t be here without you.,93802,4360,98162,2018-10-25
69,1055350291992731648,Thu Oct 25 06:48:11 +0000 2018,@mikearildbrown @MartyHungerford Same,738,28,766,2018-10-25
70,1055350177941225473,Thu Oct 25 06:47:44 +0000 2018,@KevinJawbreaker 2025,8343,408,8751,2018-10-25
71,1055349794221117440,Thu Oct 25 06:46:13 +0000 2018,How’d they know!? https://t.co/AZh4EOrgmc,385992,86825,472817,2018-10-25
72,1055326060957429760,Thu Oct 25 05:11:54 +0000 2018,@MartyHungerford Around mid 2019,823,38,861,2018-10-25
73,1054822628077096960,Tue Oct 23 19:51:26 +0000 2018,"@houmanhemmati @FredericLambert There have been hundreds of improvements to fit &amp; finish over the years, but no maj… https://t.co/89r2gSTVzO",1787,68,1855,2018-10-23
74,1054821665782214656,Tue Oct 23 19:47:37 +0000 2018,@FredericLambert Only thing almost anyone would notice is the nose,1599,43,1642,2018-10-23
75,1054814318762459136,Tue Oct 23 19:18:25 +0000 2018,@FredericLambert Just did that to correct the front design esthetic of Model S. The nose of an electric car shouldn… https://t.co/7FkyOOmzcu,3174,113,3287,2018-10-23
76,1054812318096216064,Tue Oct 23 19:10:28 +0000 2018,"Get this question a lot, so need to clarify that there’s no such thing as a Tesla “refresh”. Other car companies do… https://t.co/iJu6nhST99",57314,3521,60835,2018-10-23
77,1054801685791436800,Tue Oct 23 18:28:13 +0000 2018,"To simplify production, many Tesla Model S &amp; X interior configs, will no longer be available after Nov 1. Order now… https://t.co/5KnlLRALXH",20687,1188,21875,2018-10-23
78,1054799846379405312,Tue Oct 23 18:20:55 +0000 2018,RT @Tesla: Overhead views from a Model 3 https://t.co/SnrL4lLwNB,0,15054,15054,2018-10-23
79,1054683528661622785,Tue Oct 23 10:38:42 +0000 2018,"@cleantechnica Model 3 body design could def be less complex, but, yes, most of weight difference is due to higher safety vs other cars",7093,287,7380,2018-10-23
80,1054611698626158593,Tue Oct 23 05:53:17 +0000 2018,@vicentes Working on it,840,25,865,2018-10-23
81,1054602802880626689,Tue Oct 23 05:17:56 +0000 2018,@jeanrodriguez3 That is correct,17119,638,17757,2018-10-23
82,1054601360530784258,Tue Oct 23 05:12:12 +0000 2018,Twitter thought I got hacked &amp; locked my account haha,224586,20857,245443,2018-10-23
83,1054520588734058496,Mon Oct 22 23:51:15 +0000 2018,@vicentes @Grimezsz Wanna buy some Bitcoin? 😉😉 https://t.co/9ZbBJ5fuVq,24828,8901,33729,2018-10-22
84,1054510095491428352,Mon Oct 22 23:09:33 +0000 2018,And I own a chibi Wolverine,109676,11253,120929,2018-10-22
85,1054509050350555136,Mon Oct 22 23:05:24 +0000 2018,@Kirinodere https://t.co/2exdO1Hoks,30369,12828,43197,2018-10-22
86,1054501056229588992,Mon Oct 22 22:33:38 +0000 2018,i🖤anime,471052,155129,626181,2018-10-22
87,1054496095819116544,Mon Oct 22 22:13:55 +0000 2018,"Order Tesla without test drive &amp; you get 3 days to return for refund, else 1 day https://t.co/FRHLAB7qsj",25031,1211,26242,2018-10-22
88,1054490338570584064,Mon Oct 22 21:51:02 +0000 2018,@FredericLambert Former,849,29,878,2018-10-22
89,1054490213693542400,Mon Oct 22 21:50:33 +0000 2018,@migueldeicaza Will be in next point release,822,25,847,2018-10-22
90,1054488872703340544,Mon Oct 22 21:45:13 +0000 2018,"@KM1313 Hopefully, a few months for Drive on Navigation capability. We need to address differences in how lane line… https://t.co/ZOlqW3XXE4",2552,107,2659,2018-10-22
91,1054439668731629568,Mon Oct 22 18:29:42 +0000 2018,@Erdayastronaut @nextspaceflight Good point …,992,37,1029,2018-10-22
92,1054436171311247360,Mon Oct 22 18:15:48 +0000 2018,@mayemusk @cleantechnica @nytimes @Tesla @businessinsider @business @TheStreet @CNBC @Forbes Interesting,983,55,1038,2018-10-22
93,1054434449725652992,Mon Oct 22 18:08:57 +0000 2018,"@nextspaceflight @Erdayastronaut This is a ~ 6000 ft demo tunnel. First operational, high-speed tunnel still set fo… https://t.co/pm4SCmV9Yj",946,62,1008,2018-10-22
94,1054168068253872128,Mon Oct 22 00:30:27 +0000 2018,@nextspaceflight @Erdayastronaut Under LA (Hawthorne),1439,76,1515,2018-10-22
95,1054167945230700544,Mon Oct 22 00:29:58 +0000 2018,@nextspaceflight @Erdayastronaut 155 mph | 250 km/h,1719,93,1812,2018-10-22
96,1054167515792793600,Mon Oct 22 00:28:15 +0000 2018,@Erdayastronaut Opening event that night &amp; free rides for the public next day,2167,151,2318,2018-10-22
97,1054166993983569920,Mon Oct 22 00:26:11 +0000 2018,"@PkmnMasterHolly Pretty close, actually",7721,156,7877,2018-10-22
98,1054165297374982144,Mon Oct 22 00:19:26 +0000 2018,@vikrantsingh I think real,1507,48,1555,2018-10-22
99,1054164838430064640,Mon Oct 22 00:17:37 +0000 2018,Opens Dec 10,45962,2465,48427,2018-10-22
100,1054164543922823168,Mon Oct 22 00:16:27 +0000 2018,The first tunnel is almost done,116366,9693,126059,2018-10-22
101,1054124703663542274,Sun Oct 21 21:38:08 +0000 2018,@Grimezsz N00B!,6679,789,7468,2018-10-21
102,1054115562769416192,Sun Oct 21 21:01:49 +0000 2018,Twitter is Dark Souls of social media. Reddit is Bloodborne. Insta is Zelda.,243665,53178,296843,2018-10-21
103,1054111800004767744,Sun Oct 21 20:46:52 +0000 2018,@davidjfrankel Good idea!,607,16,623,2018-10-21
104,1054111709332291584,Sun Oct 21 20:46:30 +0000 2018,"@Erdayastronaut @Tesla @KerbalSpaceP This game is my personal favorite, but I am biased towards space stuff",4820,141,4961,2018-10-21
105,1054060824203907072,Sun Oct 21 17:24:18 +0000 2018,@AlexSafahi Coming soon,536,12,548,2018-10-21
106,1054060263257792512,Sun Oct 21 17:22:04 +0000 2018,@grobichaux Turn on enhanced security via the settings page. This will require entering a passcode to use the car.,618,36,654,2018-10-21
107,1054041324662341632,Sun Oct 21 16:06:49 +0000 2018,@WilliamShatner @SpaceX ♥️,9002,196,9198,2018-10-21
108,1053505243143524354,Sat Oct 20 04:36:37 +0000 2018,"@BoredElonMusk Digital Style!
https://t.co/aBkfpz6tvt",4495,313,4808,2018-10-20
109,1053504673007591425,Sat Oct 20 04:34:21 +0000 2018,@JaneidyEve @BoredElonMusk Would I really let someone get away with using my name all this time?,4662,157,4819,2018-10-20
110,1053503899166855169,Sat Oct 20 04:31:17 +0000 2018,@BoredElonMusk BoredElonMusk is my secret troll account. It’s time people knew.,14045,1268,15313,2018-10-20
111,1053502966584332288,Sat Oct 20 04:27:35 +0000 2018,"@BoredElonMusk No, bored me, I will not",46524,2994,49518,2018-10-20
112,1053500011210625025,Sat Oct 20 04:15:50 +0000 2018,@annerajb @nynex Maybe phone as controller,980,31,1011,2018-10-20
113,1053491837099372545,Sat Oct 20 03:43:21 +0000 2018,@justin_horn @nynex Exactly,774,22,796,2018-10-20
114,1053478965828960256,Sat Oct 20 02:52:12 +0000 2018,@annerajb @nynex Coming,907,24,931,2018-10-20
115,1053477064844632064,Sat Oct 20 02:44:39 +0000 2018,@nynex Yes,1584,110,1694,2018-10-20
116,1053469867452452864,Sat Oct 20 02:16:03 +0000 2018,@FortniteGame Reality is hard,65595,7999,73594,2018-10-20
117,1053432175696048130,Fri Oct 19 23:46:17 +0000 2018,@TSM_Myth Online doesn’t count,51985,11193,63178,2018-10-19
118,1053431641723400192,Fri Oct 19 23:44:09 +0000 2018,@Braden_Holtgod Coming soon,1000,32,1032,2018-10-19
119,1053431331244265474,Fri Oct 19 23:42:55 +0000 2018,@Newtling No,2645,101,2746,2018-10-19
120,1053430213281906688,Fri Oct 19 23:38:29 +0000 2018,@okchaserthunder That’s next,11091,1111,12202,2018-10-19
121,1053390822991790083,Fri Oct 19 21:01:57 +0000 2018,Had to been done ur welcome https://t.co/7jT0f9lqIS,1210847,399819,1610666,2018-10-19
122,1053355910364426240,Fri Oct 19 18:43:14 +0000 2018,@newscientist I hope this is true!,2532,184,2716,2018-10-19
123,1053128497747582976,Fri Oct 19 03:39:34 +0000 2018,"@planet4589 If you don’t like a Tesla for any reason or no reason, you can just give it back for a full refund",2400,230,2630,2018-10-19
124,1053068635940388865,Thu Oct 18 23:41:42 +0000 2018,@TheHoff525 Also available off menu for a week. Was causing too much confusion.,715,46,761,2018-10-18
125,1053066426532028418,Thu Oct 18 23:32:55 +0000 2018,"Model 3 long range, rear wheel drive is still available for ordering off menu for another week or so",10399,446,10845,2018-10-18
126,1053065745897148416,Thu Oct 18 23:30:13 +0000 2018,@dennishegstad It’s kind of like the post office. Same price for delivery to Maine as the SF Bay Area. But you do g… https://t.co/VNUDSFkbA3,801,50,851,2018-10-18
127,1053063107843514368,Thu Oct 18 23:19:44 +0000 2018,Tesla rear wheel drive cars do actually work well on snow &amp; ice. We did our traction testing on an ice lake! Dual m… https://t.co/87BFxfnc3h,13682,754,14436,2018-10-18
128,1053061826794016769,Thu Oct 18 23:14:39 +0000 2018,"@DannyMekic It’s a long range battery with fewer cells. Non-cell portion of the pack is disproportionately high, bu… https://t.co/02wPr8UMhG",1050,91,1141,2018-10-18
129,1053060766771761152,Thu Oct 18 23:10:26 +0000 2018,"Just released lower cost, mid-range Tesla Model 3 &amp; super simple new order page https://t.co/cz0TQn7IOZ",44347,5460,49807,2018-10-18
130,1053055538768961536,Thu Oct 18 22:49:39 +0000 2018,"RT @cleantechnica: Rewind: Akon used to have 28 cars (Lamborghinis, Ferraris, BMWs...) and ditched all the gasmobiles because the Teslas we…",0,1054,1054,2018-10-18
131,1053049266615214080,Thu Oct 18 22:24:44 +0000 2018,@IvanEscobosa Week or two,1188,46,1234,2018-10-18
132,1053049133643137024,Thu Oct 18 22:24:12 +0000 2018,Love the Reddit comments too,15209,460,15669,2018-10-18
133,1053048742985654273,Thu Oct 18 22:22:39 +0000 2018,Dog saves her puppies https://t.co/czPVEwpPhi,16445,1442,17887,2018-10-18
134,1052979047330762752,Thu Oct 18 17:45:42 +0000 2018,@3x10power8 y,656,32,688,2018-10-18
135,1052807689409945600,Thu Oct 18 06:24:48 +0000 2018,RT @nichegamer: @elonmusk Every time I think of a Lemur I think of this video https://t.co/1T20lSWeYi,0,2702,2702,2018-10-18
136,1052788115755200512,Thu Oct 18 05:07:01 +0000 2018,You’ll see,29726,2160,31886,2018-10-18
137,1052787992060936193,Thu Oct 18 05:06:31 +0000 2018,Tomorrow brings a lemur https://t.co/rm6S17h35q,62249,5667,67916,2018-10-18
138,1052694988516089861,Wed Oct 17 22:56:58 +0000 2018,Special Circumstances https://t.co/Kk36qj6XJt,19788,1002,20790,2018-10-17
139,1052621494616915968,Wed Oct 17 18:04:55 +0000 2018,@j_brorsson @smeranda Yes 😀,860,24,884,2018-10-17
140,1052621018756349952,Wed Oct 17 18:03:02 +0000 2018,@Erdayastronaut @smeranda New Summon will use the Autopilot cameras,1026,51,1077,2018-10-17
141,1052618154260619264,Wed Oct 17 17:51:39 +0000 2018,"@smeranda Yes, aiming for next few months",833,19,852,2018-10-17
142,1052618041513586688,Wed Oct 17 17:51:12 +0000 2018,"@ajmarquez True, but this will improve dramatically over next several months &amp; all Tesla cars ever produced (except… https://t.co/JXgoZFUcxW",1035,98,1133,2018-10-17
143,1052356645723021312,Wed Oct 17 00:32:30 +0000 2018,Same goes for all countries within which we officially operate by end of next year,16183,609,16792,2018-10-17
144,1052356093534302208,Wed Oct 17 00:30:19 +0000 2018,Just reviewed Tesla’s service locations in North America &amp; realized we have major gaps in geographic coverage! Sorr… https://t.co/bIIdoCjmdu,42014,2740,44754,2018-10-17
145,1052315244716941313,Tue Oct 16 21:48:00 +0000 2018,Insightful article by David @Pogue https://t.co/yo9sPUtM8I,15670,2260,17930,2018-10-16
146,1052282255261847552,Tue Oct 16 19:36:54 +0000 2018,"@ID_AA_Carmack Thanks John, really admire you too! I think you’re one of the best engineers ever. Hope you return t… https://t.co/f9ON7UVl0z",8623,346,8969,2018-10-16
147,1052130883585507328,Tue Oct 16 09:35:24 +0000 2018,@JacksMacintosh @SmileSimplify @j_brorsson @ElectrekCo @FredericLambert The FSD upgrade is the Tesla computer with our NN chip,716,44,760,2018-10-16
148,1052105289489477633,Tue Oct 16 07:53:42 +0000 2018,@SmileSimplify @j_brorsson @ElectrekCo @FredericLambert I believe it’s $5k,615,29,644,2018-10-16
149,1052104593876774912,Tue Oct 16 07:50:56 +0000 2018,@SmileSimplify @j_brorsson @ElectrekCo @FredericLambert ~6 months before it is in all new production cars. No chang… https://t.co/sOpRS04ach,1045,95,1140,2018-10-16
150,1052101714117976069,Tue Oct 16 07:39:30 +0000 2018,@j_brorsson @ElectrekCo @FredericLambert Somewhere between 500% &amp; 2000%,893,51,944,2018-10-16
151,1052101050465808384,Tue Oct 16 07:36:52 +0000 2018,"@ElectrekCo @FredericLambert To be clear, actual NN improvement is significantly overestimated in this article. V9.… https://t.co/poXspsYvgO",4175,260,4435,2018-10-16
152,1051973443602735104,Mon Oct 15 23:09:48 +0000 2018,"@ElectrekCo @FredericLambert This is without the Tesla NN computer. Per my public comments, that will give the car… https://t.co/Z8yLuu5sqc",1274,87,1361,2018-10-15
153,1051971997855506432,Mon Oct 15 23:04:03 +0000 2018,@ElectrekCo @FredericLambert Still a long way to go,7259,281,7540,2018-10-15
154,1051917544301285376,Mon Oct 15 19:27:40 +0000 2018,Model 3 motor &amp; gearbox still in good condition after driving 1M miles. Designed for ultra high endurance. https://t.co/LVO2clQZ3V,54391,7262,61653,2018-10-15
155,1051907915706032131,Mon Oct 15 18:49:25 +0000 2018,Works best if you play games full screen &amp; use steering wheel scroller balls for control https://t.co/fE51cCC5lx,14282,1157,15439,2018-10-15
156,1051876453837561857,Mon Oct 15 16:44:24 +0000 2018,@AlguireTim @Tesla Haha. It is actually my fav game on Tesla cars right now 😀,5639,141,5780,2018-10-15
157,1051866158515646464,Mon Oct 15 16:03:29 +0000 2018,🖤🖤🖤🖤  🚘🚘🚘🚘  🖤🖤🖤🖤 https://t.co/iiIWjhKiLS,13633,898,14531,2018-10-15
158,1051727134593445888,Mon Oct 15 06:51:03 +0000 2018,@TTfue @Tesla What are some of the most fun games we could have on a Tesla? Classic Atari is just the start.,15525,630,16155,2018-10-15
159,1051714470601342981,Mon Oct 15 06:00:44 +0000 2018,@TTfue Yes,76145,5222,81367,2018-10-15
160,1051591623069429760,Sun Oct 14 21:52:35 +0000 2018,"@cleantechnica Thanks for recognizing the great work of the Tesla team! 45,000 people now.",13052,591,13643,2018-10-14
161,1051389235406598144,Sun Oct 14 08:28:22 +0000 2018,It is time to create a mecha,251858,63474,315332,2018-10-14
162,1051381698682793985,Sun Oct 14 07:58:25 +0000 2018,@SURUdenise NERV,14123,3443,17566,2018-10-14
163,1051381006073118721,Sun Oct 14 07:55:40 +0000 2018,@shawnwasabi &lt;ahem&gt; Elon-chan,69268,24855,94123,2018-10-14
164,1051379120322490368,Sun Oct 14 07:48:10 +0000 2018,@StephanieeeeeJ Great. Also love Princess Mononoke.,12812,1397,14209,2018-10-14
165,1051377948916215810,Sun Oct 14 07:43:31 +0000 2018,"Love Your Name
https://t.co/fRU7nTWnML",95990,21972,117962,2018-10-14
166,1051367720111943681,Sun Oct 14 07:02:52 +0000 2018,@Sofiaan @vicentes @MrTommyCampbell @Tesla Maybe this could be part of a (safe) car version of Pokémon Go style game,1075,50,1125,2018-10-14
167,1051360789561454593,Sun Oct 14 06:35:20 +0000 2018,@NikkoMan82 @fiquett @yousuck2020 Towelie 💗,685,30,715,2018-10-14
168,1051230620234350592,Sat Oct 13 21:58:05 +0000 2018,@vicentes @MrTommyCampbell @Tesla Good idea!,937,25,962,2018-10-13
169,1051229599189807104,Sat Oct 13 21:54:02 +0000 2018,@MrTommyCampbell @Tesla Whole beer keg fits in Model 3 trunk!,12384,753,13137,2018-10-13
170,1051226218060632064,Sat Oct 13 21:40:35 +0000 2018,"@ThingsWork Wow, mechanical logic gates",8264,395,8659,2018-10-13
171,1051222706371223552,Sat Oct 13 21:26:38 +0000 2018,@ckharrison10 @yousuck2020 Comes with free towels. Nothing more useful in the entire Universe.,1622,73,1695,2018-10-13
172,1051219865661403136,Sat Oct 13 21:15:21 +0000 2018,@yousuck2020 Maybe wise to bring it just in case 👽👾 😉,19842,839,20681,2018-10-13
173,1050812486226599936,Fri Oct 12 18:16:34 +0000 2018,@owillis About half my money is intended to help problems on Earth &amp; half to help establish a self-sustaining city… https://t.co/FtLzMFhNwN,10790,2010,12800,2018-10-12
174,1050811017221963776,Fri Oct 12 18:10:44 +0000 2018,@owillis You should ask why I would want money. The reason is not what you think. Very little time for recreation.… https://t.co/5lKhBOA9gY,42214,3948,46162,2018-10-12
175,1050809457037328385,Fri Oct 12 18:04:32 +0000 2018,@technosucks Yes,614,28,642,2018-10-12
176,1050809258659344384,Fri Oct 12 18:03:45 +0000 2018,"Tesla exists to help reduce risk of catastrophic climate change, which affects all species on Earth. Even if your f… https://t.co/Y28vuHjeaG",179103,29223,208326,2018-10-12
177,1050798965371719681,Fri Oct 12 17:22:50 +0000 2018,RT @RollingStone: One of the leading climate scientists of our time is warning of the horrifying possibility of 15-to-20 feet of sea-level…,0,1361,1361,2018-10-12
178,1050792830732394496,Fri Oct 12 16:58:28 +0000 2018,Visual approximation https://t.co/sMn3Pv476Y,57613,9730,67343,2018-10-12
179,1050788043907448834,Fri Oct 12 16:39:27 +0000 2018,Teslaquila coming soon … https://t.co/AtoVGOtvVR,49586,6994,56580,2018-10-12
180,1050780165259681792,Fri Oct 12 16:08:08 +0000 2018,@AstroHague @Space_Station @NASA_Johnson @roscosmos Glad you’re safe,3359,115,3474,2018-10-12
181,1050539631836585984,Fri Oct 12 00:12:20 +0000 2018,@mhmtkcn @Tesla Beautiful picture,687,29,716,2018-10-12
182,1050535128638853121,Thu Oct 11 23:54:27 +0000 2018,"@InsideEVs @TeslaNY @Tesla Yes, it’s hard to find. Not sure why.",814,44,858,2018-10-11
183,1050529142565941248,Thu Oct 11 23:30:40 +0000 2018,"@TeslaNY @InsideEVs @Tesla Exactly. A Tesla is objectively much safer in a crash than all other cars, according to… https://t.co/A3a9wKo3CV",7589,590,8179,2018-10-11
184,1050164164805545984,Wed Oct 10 23:20:22 +0000 2018,@FinancialTimes This is incorrect,40563,2611,43174,2018-10-10
185,1049920490704388096,Wed Oct 10 07:12:06 +0000 2018,At Falcon LZ-1 Vandenberg on Sunday night with the Base Commander. Support of @USAirForce much appreciated. https://t.co/76vsbkCN6n,33275,3340,36615,2018-10-10
186,1049831543940804609,Wed Oct 10 01:18:39 +0000 2018,Studebaker Museum in South Bend https://t.co/Odti9y0McC,38067,4762,42829,2018-10-10
187,1049746303264149504,Tue Oct 09 19:39:56 +0000 2018,@thomaspower @mvolpe Punctuality is not my strong suit,1569,108,1677,2018-10-09
188,1049745772764454914,Tue Oct 09 19:37:50 +0000 2018,@SnowSnowSnow @mvolpe We’d be nothing without our fans,989,52,1041,2018-10-09
189,1049745089294213120,Tue Oct 09 19:35:07 +0000 2018,@mvolpe Because 11 is obviously louder than 10 😀,986,40,1026,2018-10-09
190,1049716203676037122,Tue Oct 09 17:40:20 +0000 2018,@FredericLambert No such thing as a “full refresh” at Tesla or even a model year. Our cars are partially upgraded e… https://t.co/Mmebu1ZCcZ,1321,145,1466,2018-10-09
191,1049704365630533632,Tue Oct 09 16:53:17 +0000 2018,@wonderofscience It sure does. Very reliable.,1521,53,1574,2018-10-09
192,1049703964290080768,Tue Oct 09 16:51:42 +0000 2018,@davidquearney You are right,1264,42,1306,2018-10-09
193,1049679307839131648,Tue Oct 09 15:13:43 +0000 2018,A reminder of why it’s important to accelerate advent of cars powered by electricity made from solar power https://t.co/sbjSZOeF4c,29307,6424,35731,2018-10-09
194,1049546078327005186,Tue Oct 09 06:24:19 +0000 2018,RT @justinemusk: Very pleased + proud that my ex -- you might have heard of him -- helped get this documentary made about (one of my heroin…,0,741,741,2018-10-09
195,1049545588138627072,Tue Oct 09 06:22:22 +0000 2018,"@justinemusk You’re most welcome, glad I could be helpful! Thanks for letting me know about it.",6222,189,6411,2018-10-09
196,1049501234258800640,Tue Oct 09 03:26:07 +0000 2018,RT @cleantechnica: Tesla Model 3 Is #1 Top Selling American Car In USA https://t.co/2nPhWy46mx https://t.co/IbxsxBdDzK,0,1224,1224,2018-10-09
197,1049408539280568320,Mon Oct 08 21:17:47 +0000 2018,@jonostrower Warms my ❤️ 😀,7956,177,8133,2018-10-08
198,1049402753481494528,Mon Oct 08 20:54:48 +0000 2018,RT @SpaceX: Video recap of last night’s launch and landing https://t.co/QRcyZQp612,0,10560,10560,2018-10-08
199,1049380879821234176,Mon Oct 08 19:27:52 +0000 2018,RT @ElectrekCo: Tesla Model 3 achieves lowest probability of injury of any vehicle ever tested by NHTSA https://t.co/Vi0efXtmgG by @frederi…,0,1578,1578,2018-10-08
200,1049363997617582081,Mon Oct 08 18:20:47 +0000 2018,RT @mayemusk: .@medium explains the negative @tesla headlines by ⁦@CNBC⁩ ⁦@nytimes⁩ ⁦@business⁩ ⁦@MarketWatch⁩ and others. Not nice. #clean…,0,1095,1095,2018-10-08
201,1049324263201591298,Mon Oct 08 15:42:54 +0000 2018,RT @Tesla: Model 3 has the lowest intrusion from side pole impact of any vehicle tested by @NHTSAgov https://t.co/RJEn0LlVNi https://t.co/Z…,0,2047,2047,2018-10-08
202,1049324244306341889,Mon Oct 08 15:42:50 +0000 2018,RT @Tesla: Model 3 provides superior safety with its front crumple zone which is optimized to absorb energy and crush upon impact https://t…,0,1325,1325,2018-10-08
203,1049324111367815169,Mon Oct 08 15:42:18 +0000 2018,"The physics of how Tesla achieved best safety of any cars ever tested. Note, when vehicle weight is taken into acco… https://t.co/p2vA0WYKw1",29992,3536,33528,2018-10-08
204,1049197364638928896,Mon Oct 08 07:18:39 +0000 2018,https://t.co/kB6RBscyYH,49967,4205,54172,2018-10-08
205,1049157574132621312,Mon Oct 08 04:40:32 +0000 2018,(Credit @_TomCross_) https://t.co/ZsRRVy2iDS,81442,11851,93293,2018-10-08
206,1049156232030736385,Mon Oct 08 04:35:12 +0000 2018,Falcon has landed https://t.co/joqphUs1AO,191167,25715,216882,2018-10-08
207,1049052181872005121,Sun Oct 07 21:41:45 +0000 2018,"RT @SpaceX: Falcon 9 and SAOCOM 1A are vertical on SpaceX's launch pad at Vandenberg AFB. Following today’s launch at 7:21 p.m. PDT, SpaceX…",0,2326,2326,2018-10-07
208,1049045561792294912,Sun Oct 07 21:15:26 +0000 2018,"Tesla owner shows how well ultrawhite seats hold up after 25,000 miles. The black &amp; white interior is def best imo. https://t.co/vWQ8X8JHYF",11095,720,11815,2018-10-07
209,1049009539356360704,Sun Oct 07 18:52:18 +0000 2018,RT @w00ki33: SAOCOM-1A Falcon is perched and ready this morning at Vandenberg. Launch is sched for 7:21 pm PT. SpaceX will be attempting a…,0,1012,1012,2018-10-07
210,1049006195292307457,Sun Oct 07 18:39:01 +0000 2018,RT @verge: Watch SpaceX attempt to land its Falcon 9 rocket on the California coast for the first time https://t.co/Yxf34Ss8m1 https://t.co…,0,734,734,2018-10-07
211,1048826568963809280,Sun Oct 07 06:45:14 +0000 2018,RT @cleantechnica: Tesla Model 3 Total Cost of Ownership Estimate — Crushing It https://t.co/FMyRAGVcBV https://t.co/sSXgV3jxXp,0,459,459,2018-10-07
212,1048822314656133120,Sun Oct 07 06:28:20 +0000 2018,RT @SpaceX: SpaceX’s West Coast landing zone https://t.co/OykcwiOg18,0,3559,3559,2018-10-07
213,1048698915384483840,Sat Oct 06 22:17:59 +0000 2018,@gnash What city &amp; what Model 3 config?,503,18,521,2018-10-06
214,1048697747451215872,Sat Oct 06 22:13:21 +0000 2018,@CroWarrior1978 My fav character,1913,74,1987,2018-10-06
215,1048697377916243969,Sat Oct 06 22:11:53 +0000 2018,"Sonic boom warning. This won’t be subtle.
https://t.co/WY7dn6BBY1",18374,2585,20959,2018-10-06
216,1048692170377506817,Sat Oct 06 21:51:11 +0000 2018,@AsbjornLD @martinengwicht @Jason @Tesla Two — one for 👽 👾 millions of years from now and one for you,667,36,703,2018-10-06
217,1048690159875588096,Sat Oct 06 21:43:12 +0000 2018,@martinengwicht @Jason @Tesla Yes,623,18,641,2018-10-06
218,1048689415306924032,Sat Oct 06 21:40:14 +0000 2018,"@incentives101 @Jason @Tesla Yes, but 🐻 in 🧠 that we’re creating a generalized autonomy solution. Must work in mill… https://t.co/bNyx75ebWe",774,59,833,2018-10-06
219,1048685509634011136,Sat Oct 06 21:24:43 +0000 2018,Blade Runner — Esper Edition — Vangelis https://t.co/DiwsRmaDA0,6718,766,7484,2018-10-06
220,1048679020512960512,Sat Oct 06 20:58:56 +0000 2018,"@Jason @Tesla Actually, it’s 1 of 3 forward cameras in rear view mirror assembly. External cameras will auto-activa… https://t.co/tNWN23lENt",6808,413,7221,2018-10-06
221,1048317881228771329,Fri Oct 05 21:03:54 +0000 2018,"RT @Tesla: 4/Mobile app: start software updates, send a destination to navigation and control media in your Tesla through the mobile app ht…",0,624,624,2018-10-05
222,1048317852871094272,Fri Oct 05 21:03:47 +0000 2018,"RT @Tesla: 3/ New apps: there is now a web browser, calendar and an energy app for Model 3 https://t.co/aFXbrYR3xI",0,404,404,2018-10-05
223,1048317829840166912,Fri Oct 05 21:03:42 +0000 2018,RT @Tesla: 2/ Dashcam: record and store video from the forward-facing camera in your car https://t.co/dm3cy98dVg,0,548,548,2018-10-05
224,1048251418233073664,Fri Oct 05 16:39:48 +0000 2018,@martyeuler @MebFaber Fair point 😀,847,46,893,2018-10-05
225,1048250837384847361,Fri Oct 05 16:37:29 +0000 2018,"@MebFaber When something sounds too good to be true, it usually is. Way the trick works is companies like Blackrock… https://t.co/b6MGuroYk5",749,87,836,2018-10-05
226,1048240246498840577,Fri Oct 05 15:55:24 +0000 2018,"@MebFaber Not all. However, shorting applied to market as a whole is obv net negative — it incents negative gdp! Mo… https://t.co/tmaGDh8iLb",3208,351,3559,2018-10-05
227,1048118186518835200,Fri Oct 05 07:50:23 +0000 2018,@Model3Owners V9 moving to wide release now. Holding back Autopilot drive on navigation for a few more weeks of val… https://t.co/1CjYnNkiE7,1432,162,1594,2018-10-05
228,1048115325336580096,Fri Oct 05 07:39:01 +0000 2018,@mgerrydoyle Only if they’re extremely tiny,651,26,677,2018-10-05
229,1048115027427778560,Fri Oct 05 07:37:50 +0000 2018,@megnsander We don’t judge. Any pic you want!,3886,191,4077,2018-10-05
230,1048114562694696966,Fri Oct 05 07:35:59 +0000 2018,Tesla owners can refer someone to buy a Tesla &amp; get any image they want laser etched in glass &amp; sent to deep space… https://t.co/qTEyCAkgJA,27199,3641,30840,2018-10-05
231,1048109695867604992,Fri Oct 05 07:16:39 +0000 2018,@eugenegu Rococo Basilisk is,599,56,655,2018-10-05
232,1048106107636314112,Fri Oct 05 07:02:23 +0000 2018,First Falcon 9 land landing mission from Vandenberg Air Force Base in California coming up soon! https://t.co/q8D3mnrSnv,11624,1003,12627,2018-10-05
233,1048105310685093888,Fri Oct 05 06:59:13 +0000 2018,"RT @Tesla: How the world's biggest lithium-ion battery works
https://t.co/MXudsn71B7",0,1635,1635,2018-10-05
234,1048019745847406593,Fri Oct 05 01:19:13 +0000 2018,@annerajb @KishavanBhola @enn_nafnlaus @ElonBachman The CIO of a major pension fund is the one who deserves credit for uncovering this scam,936,59,995,2018-10-05
235,1048015756569407488,Fri Oct 05 01:03:22 +0000 2018,"@annerajb @KishavanBhola @enn_nafnlaus @ElonBachman The big funds can &amp; will, as they’re suffering a net loss. Inde… https://t.co/DN4HbVwr8e",985,92,1077,2018-10-05
236,1048014608869408768,Fri Oct 05 00:58:48 +0000 2018,"@dlauer @KishavanBhola @enn_nafnlaus @ElonBachman Debatably true, if applied to individual stocks selectively &amp; con… https://t.co/f7bg5gmPSO",545,42,587,2018-10-05
237,1048013467247042561,Fri Oct 05 00:54:16 +0000 2018,"@KishavanBhola @enn_nafnlaus @ElonBachman Where this breaks down is in passive index funds, which constitute most o… https://t.co/S0bDaeVbGW",1180,99,1279,2018-10-05
238,1048012161002270720,Fri Oct 05 00:49:04 +0000 2018,@KishavanBhola @enn_nafnlaus @ElonBachman There is no rational basis for a long holder to lend their stock to short… https://t.co/0szf2iZKMb,1309,108,1417,2018-10-05
239,1048008592983347201,Fri Oct 05 00:34:54 +0000 2018,@Erdayastronaut I hope to be less wrong over time,1424,114,1538,2018-10-05
240,1048000425708797953,Fri Oct 05 00:02:27 +0000 2018,@FlintSchools @MuskFoundation You’re most welcome. Hope to do more to help in the future.,3824,256,4080,2018-10-05
241,1047998560782827520,Thu Oct 04 23:55:02 +0000 2018,What they do should be illegal,12424,784,13208,2018-10-04
242,1047997866474594304,Thu Oct 04 23:52:16 +0000 2018,The last several years have taught me that they are indeed reasonably maligned,10842,620,11462,2018-10-04
243,1047993455626997760,Thu Oct 04 23:34:45 +0000 2018,@nairbv The opposite is true,1475,55,1530,2018-10-04
244,1047979709898735617,Thu Oct 04 22:40:08 +0000 2018,@FCalciu @derekGUMB @Scobleizer @Tesla @SEC_Enforcement Exactly. Short-sellers are value destroyers. Should definitely be illegal.,1350,203,1553,2018-10-04
245,1047971769934524416,Thu Oct 04 22:08:34 +0000 2018,"RT @jaredmecham: I'm a little obsessed. I've never had so much fun driving a car! In fact, it doesn't even feel like a car. It's a new, inc…",0,846,846,2018-10-04
246,1047970829055623168,Thu Oct 04 22:04:50 +0000 2018,RT @TommyIgoe: I’ll never buy a gas car again. That’s how incredible  this @Tesla #Model3 is. It’s literally like driving in the future. Th…,0,511,511,2018-10-04
247,1047968979841503232,Thu Oct 04 21:57:29 +0000 2018,"By revenue, taking publicly available selling prices, Model 3 actually outsold Camry by a factor of two https://t.co/1ZTDk8HvJh",12708,1475,14183,2018-10-04
248,1047967059559112704,Thu Oct 04 21:49:51 +0000 2018,@dailystem @LFlemingEDU @atkauffman @JustinAglio @TheTechRabbi @smgaillard @jsnhubbard @mrnavas @WickedDecent… https://t.co/sXOPyntUlh,485,48,533,2018-10-04
249,1047966158836514816,Thu Oct 04 21:46:17 +0000 2018,@Model3Owners Almost ready. We expanded the early access program to 1000 more users a few days ago.,2094,104,2198,2018-10-04
250,1047965410392297472,Thu Oct 04 21:43:18 +0000 2018,People sometimes forget that a company is just a group of people gathered together to make products. So long as it… https://t.co/EFFQFBxdAy,71338,9697,81035,2018-10-04
251,1047963507625345024,Thu Oct 04 21:35:45 +0000 2018,"@BullTesla @iavor If you think Tesla is overvalued compared to probable value of future cash flows, sell. Otherwise, buy.",2934,282,3216,2018-10-04
252,1047960924051525632,Thu Oct 04 21:25:29 +0000 2018,"@iavor Hang in there. If you are truly long-term, it will be fine.",3286,239,3525,2018-10-04
253,1047957897315934208,Thu Oct 04 21:13:27 +0000 2018,@Scobleizer @Tesla True,648,19,667,2018-10-04
254,1047953389743554560,Thu Oct 04 20:55:32 +0000 2018,@Scobleizer @Tesla Sorry about the typo. That was unforgivable. Why would they be upset about their mission? It’s what they do.,2618,123,2741,2018-10-04
255,1047943670350020608,Thu Oct 04 20:16:55 +0000 2018,Just want to that the Shortseller Enrichment Commission is doing incredible work. And the name change is so on point!,36835,5221,42056,2018-10-04
256,1047940912175706112,Thu Oct 04 20:05:57 +0000 2018,Great verdict 😀 https://t.co/Ml83b0Nssm,10586,790,11376,2018-10-04
257,1047935024694087680,Thu Oct 04 19:42:34 +0000 2018,"RT @Tesla: Q3 2018 Vehicle Safety Report
https://t.co/uGlGAuGC0j",0,1044,1044,2018-10-04
258,1047005880619814912,Tue Oct 02 06:10:29 +0000 2018,@scottwww @cleantechnica Could be worse 😇,1238,58,1296,2018-10-02
259,1047005194180022273,Tue Oct 02 06:07:45 +0000 2018,@incentives101 @cleantechnica Tesla Autopilot team is awesome! Got to make sure we iron out the details though. Lon… https://t.co/12RrMq4HSU,1475,109,1584,2018-10-02
260,1046969370486935553,Tue Oct 02 03:45:24 +0000 2018,RT @SpaceX: We ❤️ @NASA! You have inspired and shown the world to believe the impossible is possible. SpaceX is proud to partner with @NASA…,0,4320,4320,2018-10-02
261,1046969213854932992,Tue Oct 02 03:44:46 +0000 2018,@cleantechnica Something especially weird going on with Yahoo news feed on iPhone stocks app. Almost always super n… https://t.co/U6akeEhfMU,8559,563,9122,2018-10-02
262,1046676717350268928,Mon Oct 01 08:22:30 +0000 2018,"Naughty by Nature 😉
https://t.co/muZdxJWjyZ",26727,2924,29651,2018-10-01
263,1046062919438536707,Sat Sep 29 15:43:29 +0000 2018,@krobertson @Tesla @kimbal @senorsisig Will do. Definitely moving heavily towards direct to work/home delivery of cars!,1176,72,1248,2018-09-29
264,1045855998836011008,Sat Sep 29 02:01:15 +0000 2018,@alitofts @telsa @6pm Tesla will deliver your car to you. This is the future. The way it should work.,1479,87,1566,2018-09-29
265,1045828553751711746,Sat Sep 29 00:12:12 +0000 2018,That was intense https://t.co/8308Zfmnoj,42840,3868,46708,2018-09-29
266,1045793457929826304,Fri Sep 28 21:52:44 +0000 2018,@Model3Owners i❤️🇨🇦,2518,199,2717,2018-09-28
267,1045789638697267200,Fri Sep 28 21:37:34 +0000 2018,@Model3Owners !! Will take action.,2019,64,2083,2018-09-28
268,1045789091801919488,Fri Sep 28 21:35:23 +0000 2018,And remember … https://t.co/UaDUv4OlZf,151723,21039,172762,2018-09-28
269,1045788510039371777,Fri Sep 28 21:33:05 +0000 2018,Huge thank you to all Tesla supporters for helping with car deliveries all around the world. You rock!!,42149,2013,44162,2018-09-28
270,1045786144422543361,Fri Sep 28 21:23:41 +0000 2018,Sorry for difficulties delivering your Tesla due to high volume! Critical to show that environmentally sustainable… https://t.co/fXJx3MkSjR,32584,2158,34742,2018-09-28
271,1045152668581163008,Thu Sep 27 03:26:28 +0000 2018,RT @geekwire: Japan’s ispace strikes deal with SpaceX for launches to the moon in 2020 and 2021 https://t.co/gTwpJqtbxg,0,1664,1664,2018-09-27
272,1045016610006654976,Wed Sep 26 18:25:49 +0000 2018,@scottwww @Tesla Pace of innovation is all that matters in the long run,12591,1213,13804,2018-09-26
273,1045006132475883520,Wed Sep 26 17:44:11 +0000 2018,@ctbarker32 @BDL3J @Tesla You’re welcome. Sorry for the delay!,868,33,901,2018-09-26
274,1045004446076301312,Wed Sep 26 17:37:29 +0000 2018,@Agent_KO @Starflightgame @SpaceX @starcontrolgame What would be great is original Elite,746,47,793,2018-09-26
275,1044689341493067776,Tue Sep 25 20:45:23 +0000 2018,@neveryb Going over final tweaks tonight. Hopefully in wide release end of week.,1348,109,1457,2018-09-25
276,1044688678042271744,Tue Sep 25 20:42:44 +0000 2018,♥️ Tesla Owners ♥️ https://t.co/YbzovKbfgj,61892,3289,65181,2018-09-25
277,1044663329019518976,Tue Sep 25 19:02:01 +0000 2018,"@ParkerWoolfolk Increased tire pressure improves range. Also, if you have performance tires, they are stickier. Bet… https://t.co/OUTOzOiVYh",713,39,752,2018-09-25
278,1044623575359975425,Tue Sep 25 16:24:03 +0000 2018,@ftomenko @Tesla 😀,3884,80,3964,2018-09-25
279,1044294753041313792,Mon Sep 24 18:37:25 +0000 2018,"@ctbarker32 Apologies, we’re upgrading our logistics system, but running into an extreme shortage of car carrier tr… https://t.co/0Uxn6o2GWC",1550,148,1698,2018-09-24
280,1044123822956306432,Mon Sep 24 07:18:12 +0000 2018,@slashdot Tricky one,3943,167,4110,2018-09-24
281,1043293219205787648,Sat Sep 22 00:17:41 +0000 2018,"@DMC_Ryan Wow, thanks for offering to help! The coming week is incredibly intense. If any current Tesla owners who’… https://t.co/xxykP10x6l",2900,364,3264,2018-09-22
282,1043253619485622272,Fri Sep 21 21:40:20 +0000 2018,@NASASpaceflight Probably 2028 for a base to be built,8917,820,9737,2018-09-21
283,1043250540379926528,Fri Sep 21 21:28:06 +0000 2018,Mars Base Alpha https://t.co/O1llQp8rFY,247680,40249,287929,2018-09-21
284,1043250454648344576,Fri Sep 21 21:27:45 +0000 2018,https://t.co/Fn0hKJd3uJ,78101,6894,84995,2018-09-21
285,1043222336290222085,Fri Sep 21 19:36:01 +0000 2018,RT @chrisccollins: Here's a @Tesla spec ad I cut for fun. @elonmusk @TeslaMotorsClub @SpaceX #tesla #specad #elonmusk #spacex https://t.co/…,0,5543,5543,2018-09-21
286,1042849087194714112,Thu Sep 20 18:52:52 +0000 2018,"@LanceUlanoff Consider an ice skater. Same weight, but spins/turns much faster with arms in vs arms out. Same principle is true for a car.",1143,66,1209,2018-09-20
287,1042848713079570432,Thu Sep 20 18:51:23 +0000 2018,"@LanceUlanoff Front vs rear wheel weight distribution, though commonly asked, isn't the right question. You can hav… https://t.co/3pK3SF4qo4",1047,69,1116,2018-09-20
288,1042845665498357760,Thu Sep 20 18:39:16 +0000 2018,@LanceUlanoff Simple explanation of polar moment of inertia &amp; other important car terms at https://t.co/CftQ1v9YCL,969,84,1053,2018-09-20
289,1042842449008197632,Thu Sep 20 18:26:29 +0000 2018,@LanceUlanoff Key technical point is that the polar moment of inertia (concentration of mass around center) of a Te… https://t.co/uYKz5PsDWH,1249,102,1351,2018-09-20
290,1042838924710764545,Thu Sep 20 18:12:29 +0000 2018,@martinengwicht @BlondesE A car propelled by combustion is far more likely to combust than an electric car,1496,140,1636,2018-09-20
291,1042834199705608192,Thu Sep 20 17:53:42 +0000 2018,"@LanceUlanoff Yes, when it comes to physics, make sure Newton is on your side",1298,86,1384,2018-09-20
292,1042832989707677697,Thu Sep 20 17:48:54 +0000 2018,"@LanceUlanoff Helps improve forward crumple zone length, especially important in high speed frontal impacts, and mo… https://t.co/t95fsywjre",966,45,1011,2018-09-20
293,1042832003937099776,Thu Sep 20 17:44:59 +0000 2018,Tesla piece on the physics of car safety coming soon for those interested in technical details,14774,823,15597,2018-09-20
294,1042829474914430977,Thu Sep 20 17:34:56 +0000 2018,"@MartenBenjamin @NHTSAgov @Tesla Exactly, all 5 star are *not* the same, as the videos show. “5 star” just means a… https://t.co/Rc6K76EtLJ",1395,116,1511,2018-09-20
295,1042828379806810112,Thu Sep 20 17:30:35 +0000 2018,@Cardoso @NHTSAgov Haha true,1176,54,1230,2018-09-20
296,1042827334758260736,Thu Sep 20 17:26:26 +0000 2018,.@NHTSAgov will post final safety probability stats soon. Model 3 has a shot at being safest car ever tested.,19977,1774,21751,2018-09-20
297,1042819371976933376,Thu Sep 20 16:54:47 +0000 2018,RT @Jalopnik: Tesla Model 3 gets five-star crash safety rating from NHTSA https://t.co/Fs1rjlcrcA https://t.co/jvqmkfjSKj,0,1051,1051,2018-09-20
298,1042818849874182144,Thu Sep 20 16:52:43 +0000 2018,RT @business: Tesla Model 3 sedan aces all of U.S. safety agency's crash tests https://t.co/LlFD0pHtiE,0,1512,1512,2018-09-20
299,1042680127841169408,Thu Sep 20 07:41:29 +0000 2018,@LindseyStirling 👽💘,1418,62,1480,2018-09-20
300,1042604979561746432,Thu Sep 20 02:42:52 +0000 2018,"@primadanna @Tesla @alphacali Wow, glad they’re ok!",10481,300,10781,2018-09-20
301,1042578255948144640,Thu Sep 20 00:56:41 +0000 2018,@vicentes @DanAloni @slashdot Physics can be thought of as the compression algorithms of reality,1217,138,1355,2018-09-20
302,1042530259734683648,Wed Sep 19 21:45:57 +0000 2018,♥️ @neiltyson,28699,2841,31540,2018-09-19
303,1042525568531480576,Wed Sep 19 21:27:19 +0000 2018,@raginggoat @Tesla Tesla Rangers!,5026,115,5141,2018-09-19
304,1042525258899550209,Wed Sep 19 21:26:05 +0000 2018,"@CJDaniels77 31 engines, but with room to add 11 more down the road. Kinda have to.",1109,58,1167,2018-09-19
305,1042516607166103552,Wed Sep 19 20:51:42 +0000 2018,"@JaneidyEve @slashdot Yes, if there is no listener, a simulation probably wouldn’t spend computing power on sound",1099,78,1177,2018-09-19
306,1042515605654401024,Wed Sep 19 20:47:44 +0000 2018,@DanAloni @slashdot Yes,797,29,826,2018-09-19
307,1042515420937216001,Wed Sep 19 20:47:00 +0000 2018,"True 😀
https://t.co/CS6semhKm6",24970,3071,28041,2018-09-19
308,1042514356347396096,Wed Sep 19 20:42:46 +0000 2018,"@slashdot To conserve computing power, a simulation would only render an object when it is observed",8179,889,9068,2018-09-19
309,1042484156591046656,Wed Sep 19 18:42:46 +0000 2018,"RT @CNBCi: Tesla is 'headed for the graveyard,' predicts former GM exec Bob Lutz https://t.co/M0iIvzcKi5 https://t.co/AM9Z0DbbCz",0,366,366,2018-09-19
310,1042463081702416384,Wed Sep 19 17:19:01 +0000 2018,@megangale @Tesla You’re most welcome! Sorry for the delay.,669,27,696,2018-09-19
311,1042122288101916672,Tue Sep 18 18:44:49 +0000 2018,@Erdayastronaut Will do. Love Reddit.,2472,89,2561,2018-09-18
312,1042120326027476992,Tue Sep 18 18:37:02 +0000 2018,@Cardoso @SoundBoy264 Space Bar,1620,51,1671,2018-09-18
313,1042119797087993856,Tue Sep 18 18:34:55 +0000 2018,"@JaneidyEve @ds23ytube Long-term, there will be thousands and eventually, hopefully, millions of missions &amp; anyone will be able to go",1111,87,1198,2018-09-18
314,1042117772279283712,Tue Sep 18 18:26:53 +0000 2018,"@perthguppy Yeah, Starlink should be active by then",4852,166,5018,2018-09-18
315,1042117514350608384,Tue Sep 18 18:25:51 +0000 2018,@LisaPadgett @bocio777 @TArkesteijn Sorry! So many bots!!,1390,20,1410,2018-09-18
316,1042117285568073728,Tue Sep 18 18:24:57 +0000 2018,"Moon mission will be livestreamed in high def VR, so it’ll feel like you’re there in real-time minus a few seconds for speed of light",164071,24585,188656,2018-09-18
317,1042113884998397952,Tue Sep 18 18:11:26 +0000 2018,@bocio777 Perhaps one of the invited artists choosing to play. There will be no obligation to do so.,1942,39,1981,2018-09-18
318,1042113023928721408,Tue Sep 18 18:08:01 +0000 2018,@ryaneshaghi Very close,1769,52,1821,2018-09-18
319,1042112781518917633,Tue Sep 18 18:07:03 +0000 2018,https://t.co/nqgfNWlm4Z,50533,5116,55649,2018-09-18
320,1042105475360120832,Tue Sep 18 17:38:01 +0000 2018,RT @yousuck2020: Another serious shot w @elonmusk https://t.co/e11lyfjfFN,0,4488,4488,2018-09-18
321,1042079045666582529,Tue Sep 18 15:53:00 +0000 2018,@Oatmeal 😀,1424,32,1456,2018-09-18
322,1041982142635335680,Tue Sep 18 09:27:56 +0000 2018,@JamesMarstersOf @bioshock Always,563,17,580,2018-09-18
323,1041977109764173824,Tue Sep 18 09:07:56 +0000 2018,@sleepingromi @yousuck2020 @rogerwaters @SpaceX @dearmoonproject Yes,2662,76,2738,2018-09-18
324,1041953361908576256,Tue Sep 18 07:33:34 +0000 2018,@yousuck2020 @SpaceX That’s the first BFR airframe/tank barrel section made of a new carbon fiber material,6414,312,6726,2018-09-18
325,1041905891316981761,Tue Sep 18 04:24:56 +0000 2018,"@MKBHD Yeah … that’s exactly how I feel. However it happens, I just hope it does.",29961,1036,30997,2018-09-18
326,1041904749165957121,Tue Sep 18 04:20:24 +0000 2018,"RT @yousuck2020: I choose to go to the moon, with Artists. #dearMoon 
https://t.co/ivMypEcWBZ",0,8768,8768,2018-09-18
327,1041902062068359169,Tue Sep 18 04:09:43 +0000 2018,@yousuck2020 Thanks for helping fund a rocket &amp; spaceship that could take humanity beyond Earth!,9407,538,9945,2018-09-18
328,1041880316657336320,Tue Sep 18 02:43:19 +0000 2018,Hanging out with @yousuck2020 before the @SpaceX moon mission announcement https://t.co/RTOwutzMtG,64776,9526,74302,2018-09-18
329,1041879789341048832,Tue Sep 18 02:41:13 +0000 2018,Yusaku will be bringing 8 (brave) artists &amp; cultural figures with him on the journey around the moon! https://t.co/PCU23HYTa9,37631,6034,43665,2018-09-18
330,1041829367037407232,Mon Sep 17 23:20:52 +0000 2018,@martinengwicht @iamacloudguy @Model3Owners Probably V10 alpha build,696,32,728,2018-09-17
331,1041829117493108736,Mon Sep 17 23:19:52 +0000 2018,"@DMC_Ryan @iamacloudguy @Model3Owners Yes, albeit a beta version. Will improve with V9.1.",807,33,840,2018-09-17
332,1041826260115120128,Mon Sep 17 23:08:31 +0000 2018,@iamacloudguy @Model3Owners Good news on this front. Tesla engineering rallied &amp; this will be part of V9. Going through final testing now.,6107,298,6405,2018-09-17
333,1041825772703408129,Mon Sep 17 23:06:35 +0000 2018,Thank you for your trust in the @SpaceX team. Greatly appreciated. https://t.co/hqZPNdoMlr,13787,889,14676,2018-09-17
334,1041802266221535232,Mon Sep 17 21:33:10 +0000 2018,@cleantechnica Will be interesting to see how this evolves over time,2922,97,3019,2018-09-17
335,1041798613628678144,Mon Sep 17 21:18:39 +0000 2018,@NigelKBaker Will see what we can do. Really need to bring this program to an end while being as fair as possible.… https://t.co/iT8OBACB6M,570,28,598,2018-09-17
336,1041796740347703296,Mon Sep 17 21:11:13 +0000 2018,@martinengwicht Very interesting,582,27,609,2018-09-17
337,1041793769106853888,Mon Sep 17 20:59:24 +0000 2018,"Due to some Tesla owners encountering system issues yesterday, the free Supercharging referral program will be exte… https://t.co/9o0OLxnJXx",7559,517,8076,2018-09-17
338,1041771381636063232,Mon Sep 17 19:30:27 +0000 2018,@beardyman This is definitely worth thoughtful debate. What might we do differently to improve human/life happiness?,1184,65,1249,2018-09-17
339,1041768314068824064,Mon Sep 17 19:18:15 +0000 2018,"@LanceUlanoff @SpaceX @NASA Yes, I do",2358,52,2410,2018-09-17
340,1041767801118121984,Mon Sep 17 19:16:13 +0000 2018,Top SpaceX priority is and will remain supporting @NASA crewed spaceflight and National Security missions,20146,960,21106,2018-09-17
341,1041766343769387008,Mon Sep 17 19:10:26 +0000 2018,"Btw, can’t emphasize enough how @SpaceX would not be where it is today without @NASA. Thank you.",57772,4322,62094,2018-09-17
342,1041578120573153280,Mon Sep 17 06:42:30 +0000 2018,@ConorMcDPhoto With lasers,2902,114,3016,2018-09-17
343,1041577803332775936,Mon Sep 17 06:41:14 +0000 2018,@SpaceX My fav tweet ever,28428,1743,30171,2018-09-17
344,1041572165898792961,Mon Sep 17 06:18:50 +0000 2018,"@ummjackson if you can help get rid of the annoying scam spammers, that would be much appreciated",1342,100,1442,2018-09-17
345,1041560458493255680,Mon Sep 17 05:32:19 +0000 2018,@AntVenom Ok,3332,223,3555,2018-09-17
346,1041559840919678977,Mon Sep 17 05:29:51 +0000 2018,@SwiftOnSecurity Maybe the scammers will just get tired of winning eventually,6197,226,6423,2018-09-17
347,1041559524618821633,Mon Sep 17 05:28:36 +0000 2018,"@FalconGridFin Good catch. They are there in the flight design, but we forgot to put them in this render.",1848,57,1905,2018-09-17
348,1041555319166447616,Mon Sep 17 05:11:53 +0000 2018,#OccupyMars,90840,17519,108359,2018-09-17
349,1041553238477008896,Mon Sep 17 05:03:37 +0000 2018,@vicentes Forward moving wing,1561,42,1603,2018-09-17
350,1041552529937453056,Mon Sep 17 05:00:48 +0000 2018,https://t.co/dUpiavvM1Z,85350,9385,94735,2018-09-17
351,1041552262286389253,Mon Sep 17 04:59:45 +0000 2018,https://t.co/d1KEp44zjm,83142,8846,91988,2018-09-17
352,1041548537987686400,Mon Sep 17 04:44:57 +0000 2018,@thepixelgeek 😉,1923,55,1978,2018-09-17
353,1041500594467270656,Mon Sep 17 01:34:26 +0000 2018,"@megangale @Tesla Sorry, we’ve gone from production hell to delivery logistics hell, but this problem is far more t… https://t.co/iEUNPUxKZr",7653,285,7938,2018-09-17
354,1041485596240171009,Mon Sep 17 00:34:50 +0000 2018,@RoxanaDaneshjou @boringcompany Awesome 😎,2676,60,2736,2018-09-17
355,1041482806600204294,Mon Sep 17 00:23:45 +0000 2018,"@johnkoetsier Design has been changed so the 🚀 lands on legs that extend from the tips of the three fins, two of wh… https://t.co/1wwnT9QZJ8",5267,371,5638,2018-09-17
356,1041480103539011584,Mon Sep 17 00:13:01 +0000 2018,"@nirbheek Sorry, it’s not really sustainable at volume production &amp; doesn’t incent optimal behavior. We probably sh… https://t.co/4MaDlD9AEH",604,24,628,2018-09-17
357,1041443228996710402,Sun Sep 16 21:46:29 +0000 2018,@ddkilzer Yes,552,10,562,2018-09-16
358,1041436083894943744,Sun Sep 16 21:18:06 +0000 2018,"@thereal_scottv Yeah, that’s our problem. Service &amp; parts supply in general will be the top Tesla priority after we… https://t.co/asqLQG3q1U",1086,48,1134,2018-09-16
359,1041425397659795456,Sun Sep 16 20:35:38 +0000 2018,"@SnazzyQ Outside repair shops are jack of all trades, which means supporting 1000’s of makes &amp; models. Tesla collis… https://t.co/yQav1xJpgm",1524,72,1596,2018-09-16
360,1041422616668463106,Sun Sep 16 20:24:35 +0000 2018,Goal is for repaired car to be better than before accident. Should always be true if damaged/used parts are correct… https://t.co/qY4E2MlOBd,14387,752,15139,2018-09-16
361,1041421799618052097,Sun Sep 16 20:21:20 +0000 2018,"Exciting to see some Tesla collision repair operations already completing within 24 hrs. Aiming for same day soon, then under an hour.",12866,759,13625,2018-09-16
362,1041421552300916736,Sun Sep 16 20:20:21 +0000 2018,"Tesla is bringing most collision repairs in-house, as outside firms take weeks to months for repairs, driving Tesla owners (and us) crazy",23545,1578,25123,2018-09-16
363,1041108816006283264,Sat Sep 15 23:37:39 +0000 2018,@TechGrlTweeter True,750,16,766,2018-09-15
364,1041108570740158464,Sat Sep 15 23:36:40 +0000 2018,"Tesla owners can grant free Supercharging for life to a friend who buys S/3/X. Ends tomorrow night. https://t.co/7ZDXeIQVc7""",19936,2479,22415,2018-09-15
365,1040771664751935488,Sat Sep 15 01:17:56 +0000 2018,"RT @Tesla: “After driving a Model 3, every other car’s console feels like a misuse of wires and visual real estate” @PopMech https://t.co/N…",0,1470,1470,2018-09-15
366,1040730861585354753,Fri Sep 14 22:35:47 +0000 2018,@TheTrustySteed @Tesla Hi Dustin!,3518,53,3571,2018-09-14
367,1040630345463357440,Fri Sep 14 15:56:22 +0000 2018,@JoannMuller @alanohnsman @Forbes The Tesla board has done incredible work overseeing the largest value creation in… https://t.co/cldHRAknKP,9390,578,9968,2018-09-14
368,1040611822523437056,Fri Sep 14 14:42:46 +0000 2018,"@mcwm The muskrat is like a beaver with small ideas, but it has a certain quiet dignity …",1061,63,1124,2018-09-14
369,1040609402103848960,Fri Sep 14 14:33:09 +0000 2018,@mcwm Wut? https://t.co/suB8ZFtthK,1095,66,1161,2018-09-14
370,1040607199108558850,Fri Sep 14 14:24:24 +0000 2018,@mcwm Haha 😀,8629,171,8800,2018-09-14
371,1040487333328351232,Fri Sep 14 06:28:06 +0000 2018,@FalconGridFin @SpaceX Intentionally so,1419,71,1490,2018-09-14
372,1040486759820218368,Fri Sep 14 06:25:49 +0000 2018,Electric cars made with sunlight https://t.co/utVdn9mSmy,63892,7487,71379,2018-09-14
373,1040406219905613825,Fri Sep 14 01:05:47 +0000 2018,@AntVenom @SpaceX 🇯🇵,3160,571,3731,2018-09-14
374,1040406114825715713,Fri Sep 14 01:05:22 +0000 2018,@FalconGridFin @SpaceX Yes,3103,86,3189,2018-09-14
375,1040405858839015424,Fri Sep 14 01:04:21 +0000 2018,RT @SpaceX: SpaceX has signed the world’s first private passenger to fly around the Moon aboard our BFR launch vehicle—an important step to…,0,27746,27746,2018-09-14
376,1040315648436400128,Thu Sep 13 19:05:53 +0000 2018,"RT @Commercial_Crew: From trying on spacesuits to preparing for potential emergencies, see how astronauts are getting ready to fly on the t…",0,977,977,2018-09-13
377,1040142708453457926,Thu Sep 13 07:38:41 +0000 2018,Bricks will be free if used for affordable housing projects,21645,1804,23449,2018-09-13
378,1040140704159227904,Thu Sep 13 07:30:43 +0000 2018,@CleAgentBrandon Yes,1635,42,1677,2018-09-13
379,1040139968843145216,Thu Sep 13 07:27:48 +0000 2018,First Boring Brick store opening in ~2 months. Only 10 cents a brick! Rated for California seismic loads.,16122,1295,17417,2018-09-13
380,1040139582531022848,Thu Sep 13 07:26:15 +0000 2018,@dylanstw__ @boringcompany About to finish first TBC HQ building made with Boring Bricks in the shape of a medieval watchtower,1526,113,1639,2018-09-13
381,1040138879263637504,Thu Sep 13 07:23:28 +0000 2018,.@boringcompany will transport your car all the way into your garage https://t.co/DPnkC80NWH,17899,1809,19708,2018-09-13
382,1040007391331278848,Wed Sep 12 22:40:59 +0000 2018,@SyrinxStarman @TeslaRoadTrip @Tesla Thoughtful feedback,3335,55,3390,2018-09-12
383,1039982911322087429,Wed Sep 12 21:03:42 +0000 2018,"Due to a large increase in vehicle delivery volume in North America, Tesla customers may experience longer response… https://t.co/2L1xx0mADc",33063,1776,34839,2018-09-12
384,1039982627317379072,Wed Sep 12 21:02:34 +0000 2018,"@PauloBriski @Tesla My apologies, am working on this exact issue right now",726,39,765,2018-09-12
385,1039588735157850113,Tue Sep 11 18:57:23 +0000 2018,"RT @NASAJPL: #NeverForget
There is a 9/11 tribute on Mars. The hardware with the US flag on @MarsRovers Spirit is made of aluminum recovere…",0,4025,4025,2018-09-11
386,1039449908753788928,Tue Sep 11 09:45:44 +0000 2018,RT @elonmusk: Looks so sus when we paint cars red https://t.co/SIO2nInjhJ,0,8502,8502,2018-09-11
387,1039437131976867840,Tue Sep 11 08:54:58 +0000 2018,@adultswim @RickandMorty Best show in the multiverse!,42583,4189,46772,2018-09-11
388,1039404639429390336,Tue Sep 11 06:45:51 +0000 2018,"@ebf No, service will stock all colors",2170,29,2199,2018-09-11
389,1039404142559551488,Tue Sep 11 06:43:53 +0000 2018,@DMC_Ryan @EdoubleZero Love that red. We tried every possible way to make red look 3D without floating a special re… https://t.co/fxUkaehEhS,2967,110,3077,2018-09-11
390,1039390759907020801,Tue Sep 11 05:50:42 +0000 2018,Moving 2 of 7 Tesla colors off menu on Wednesday to simplify manufacturing. Obsidian Black &amp; Metallic Silver will s… https://t.co/VYOE0im0Va,28672,1536,30208,2018-09-11
391,1039248128082292736,Mon Sep 10 20:23:56 +0000 2018,RT @InsideEVs: Blazingly quick! @Tesla #Model3 Performance Hits 60 MPH In Record-Setting 3.13 Seconds https://t.co/2JntHIlsUz,0,564,564,2018-09-10
392,1039216062858809344,Mon Sep 10 18:16:31 +0000 2018,"RT @Tesla: ""It's almost as if time slows down... it's a pleasure and a marvel to experience"" @caranddriver
https://t.co/XsHTpsfYqM",0,768,768,2018-09-10
393,1039024232208859136,Mon Sep 10 05:34:15 +0000 2018,RT @SpaceX: Successful deployment of Telstar 18 VANTAGE to a geostationary transfer orbit confirmed. https://t.co/nlRgxoILJ9,0,1964,1964,2018-09-10
394,1038911263143682049,Sun Sep 09 22:05:21 +0000 2018,RT @jack: This is an honest and fun conversation between @elonmusk and @joerogan. Stop at the headlines and memes and you’ll miss all the t…,0,4692,4692,2018-09-09
395,1038899153944735744,Sun Sep 09 21:17:14 +0000 2018,RT @SpaceX: Falcon 9 and Telstar 18 VANTAGE are vertical on Pad 40 in Florida. Weather is 60% favorable for tonight’s four-hour launch wind…,0,1903,1903,2018-09-09
396,1038545562000187392,Sat Sep 08 21:52:11 +0000 2018,@TheOceanCleanup Looks cool,5202,195,5397,2018-09-08
397,1038537654827024384,Sat Sep 08 21:20:46 +0000 2018,"Not easy coming up with a good cover story for an underground volcano lair, but I think it’s working",96116,8923,105039,2018-09-08
398,1038526444253503488,Sat Sep 08 20:36:13 +0000 2018,Test-driving our new boring machine with a 🎮 https://t.co/WBcDo8ra6p,44280,5234,49514,2018-09-08
399,1038359955781218304,Sat Sep 08 09:34:39 +0000 2018,"@Tesla_Bill @InsideEVs 2170 is about the right cell size, but I don’t recommend copying our current module design.… https://t.co/GG7Kl5by7n",4564,175,4739,2018-09-08
400,1038332059129761793,Sat Sep 08 07:43:48 +0000 2018,@caitylotz Like sands through the hourglass …,9280,287,9567,2018-09-08
401,1038152378531250176,Fri Sep 07 19:49:49 +0000 2018,@PEpicerie 10 types of people in the world: those who understand binary &amp; those who don’t 🦊🐶,2051,223,2274,2018-09-07
402,1038123885235908609,Fri Sep 07 17:56:36 +0000 2018,"@karaswisher @themightyoo @itsmanibro Will do soon, as promised",909,31,940,2018-09-07
403,1037979494814900225,Fri Sep 07 08:22:50 +0000 2018,"@xJawz @RNaegels @joerogan @peterthiel @reidhoffman Not me, I’m gonna die right here in the USA. Or Mars. Just not on impact.",1596,123,1719,2018-09-07
404,1037976743963840512,Fri Sep 07 08:11:55 +0000 2018,I am a business magnet,59169,6830,65999,2018-09-07
405,1037973950150541312,Fri Sep 07 08:00:48 +0000 2018,"Good times with @JoeRogan …
https://t.co/8uZUsEJoq1",59799,8695,68494,2018-09-07
406,1037901130578067456,Fri Sep 07 03:11:27 +0000 2018,@andrew_gold_ Will add a fade mode with only essential info,731,26,757,2018-09-07
407,1037502853680517120,Thu Sep 06 00:48:50 +0000 2018,"Tesla 1st, 2nd &amp; 3rd in August sales https://t.co/npDKC9QEpP",14243,1540,15783,2018-09-06
408,1037494368368652288,Thu Sep 06 00:15:07 +0000 2018,RT @InsideEVs: Holy cow! @Tesla #Model3 Outsold All BMW Passenger Cars In US https://t.co/NQVNz7rluQ,0,1666,1666,2018-09-06
409,1037249325464600578,Wed Sep 05 08:01:25 +0000 2018,Will be on @JoeRogan at 9:30pm Pacific on Thursday,107712,18148,125860,2018-09-05
410,1037205636021411841,Wed Sep 05 05:07:48 +0000 2018,"@andrew_gold_ Am running it in my car, but it’s not right yet. Hopefully, will release to advanced early access use… https://t.co/NwzYLhOolx",890,63,953,2018-09-05
411,1036742121271779328,Mon Sep 03 22:25:58 +0000 2018,"@mliebow @Tesla Much appreciated! Great word-of-mouth is why Model 3 is the best-selling electric car, despite no a… https://t.co/c0chjdggPv",13868,808,14676,2018-09-03
412,1036706368709787648,Mon Sep 03 20:03:54 +0000 2018,"RT @genejayne: We got our first  Tesla Model 3 in December 2017. It was so damn good, we got another one in February 18 for my son. Now, th…",0,2090,2090,2018-09-03
413,1036702307251965952,Mon Sep 03 19:47:45 +0000 2018,RT @SpaceX: Forward hatch view of Dragon departing the @Space_Station earlier this month. https://t.co/L1Kc5XI0G7,0,5552,5552,2018-09-03
414,1035356365336629249,Fri Aug 31 02:39:28 +0000 2018,"@FredericLambert @pooktd The multi-coat colors (pearl white &amp; red) are hardest, red especially, as it has red tint… https://t.co/M2JbLXNbeU",936,50,986,2018-08-31
415,1035325350119583744,Fri Aug 31 00:36:13 +0000 2018,"@pooktd Sorry, we’ve put pretty extreme rules in place for paint &amp; quality in general. If need be, we’re repainting… https://t.co/hvVy6H0i1i",1077,56,1133,2018-08-31
416,1035320831725920256,Fri Aug 31 00:18:16 +0000 2018,@CNN Can Steve Bannon please insult me some more? Best PR I’ve had in a while.,56755,4644,61399,2018-08-31
417,1035302220995018752,Thu Aug 30 23:04:19 +0000 2018,"RT @Tesla: ""Track Mode left me literally shaking with adrenaline"" @roadshow 
https://t.co/Et46ft1905",0,1042,1042,2018-08-30
418,1035029257557237760,Thu Aug 30 04:59:39 +0000 2018,@ElectrekCo @FredericLambert !,8392,431,8823,2018-08-30
419,1034654594670841856,Wed Aug 29 04:10:52 +0000 2018,@GlamandGore I was told that his parents preferred that his name not be mentioned,6981,143,7124,2018-08-29
420,1034489064659939328,Tue Aug 28 17:13:07 +0000 2018,@JohnnaCrider1 V cool,4634,139,4773,2018-08-28
421,1034486631351242752,Tue Aug 28 17:03:27 +0000 2018,@yoda @RMac18 @TijenOnaran So you actually did nothing &amp; yet imply you are a truth-seeker. The Twitter name you chose is @yoda.,1708,68,1776,2018-08-28
422,1034483805397114882,Tue Aug 28 16:52:13 +0000 2018,"@yoda @RMac18 @TijenOnaran Answer the question @yoda. You brought it up, not me. Did you investigate or not? If so,… https://t.co/eBSBcnW82l",1169,52,1221,2018-08-28
423,1034483462235975681,Tue Aug 28 16:50:51 +0000 2018,"@McMurchie @alexmd2 @Techmeme @CatherineShu At this point, I want ETH even if it is a scam",5615,1974,7589,2018-08-28
424,1034482379992301568,Tue Aug 28 16:46:33 +0000 2018,@yoda @RMac18 @TijenOnaran Did you investigate at all? I’m guessing answer is no. Why?,1023,49,1072,2018-08-28
425,1034481943310749697,Tue Aug 28 16:44:49 +0000 2018,"@alexmd2 @Techmeme @CatherineShu It’s coming, I swear",1654,50,1704,2018-08-28
426,1034481160783585280,Tue Aug 28 16:41:43 +0000 2018,@yoda @RMac18 @TijenOnaran You don’t think it’s strange he hasn’t sued me? He was offered free legal services. And you call yourself @yoda …,1760,208,1968,2018-08-28
427,1034478990663274497,Tue Aug 28 16:33:05 +0000 2018,@Techmeme @CatherineShu Great actions by Twitter to delete bogus accounts. Will increase usage by real users.,4593,220,4813,2018-08-28
428,1034458577346260992,Tue Aug 28 15:11:58 +0000 2018,"@TijenOnaran For the record, my voice cracked once during the NY Times article. That’s it. There were no tears.",16308,967,17275,2018-08-28
429,1034277020283232260,Tue Aug 28 03:10:32 +0000 2018,@TheIanChen @Tesla Sure :),1013,46,1059,2018-08-28
430,1034211853646221312,Mon Aug 27 22:51:35 +0000 2018,@jwiechers @SwiftOnSecurity I want that outfit,593,17,610,2018-08-27
431,1033543361787977728,Sun Aug 26 02:35:14 +0000 2018,"The world lost a great man in John McCain. He was an honorable, kind, brave and fundamentally decent human being. I… https://t.co/KUnxG1VA4o",93251,9557,102808,2018-08-26
432,1033494945972273152,Sat Aug 25 23:22:51 +0000 2018,@GrowthHackers This is why a small company with tight focus &amp; high energy can beat a big company without,4957,505,5462,2018-08-25
433,1033494277643481089,Sat Aug 25 23:20:11 +0000 2018,@SeanHQuinn @yanquetino @Tesla This is utterly false. Fossil fuel merchants of doubt have been pushing that bs for… https://t.co/TDOivc7cy0,3693,395,4088,2018-08-25
434,1033493209446600704,Sat Aug 25 23:15:57 +0000 2018,RT @elonmusk: @yanquetino @Tesla Most people don’t realize that the cost of operating an electric vehicle is much lower than a gas car. Ele…,0,5060,5060,2018-08-25
435,1033493134645317633,Sat Aug 25 23:15:39 +0000 2018,@yanquetino @Tesla Most people don’t realize that the cost of operating an electric vehicle is much lower than a ga… https://t.co/CwCU40VmPo,40765,5060,45825,2018-08-25
436,1033405964009889792,Sat Aug 25 17:29:16 +0000 2018,@j_brorsson @InsideEVs @Tesla @AirResources Most major customers have tried it &amp; love it. Now we need to finish pro… https://t.co/uVYLiR2VAY,1315,109,1424,2018-08-25
437,1033405017175150592,Sat Aug 25 17:25:30 +0000 2018,@InsideEVs @Tesla @AirResources Maybe …,798,40,838,2018-08-25
438,1033404726585450496,Sat Aug 25 17:24:21 +0000 2018,"@AskDrStupid This was key showstopper for me personally. Couldn’t make it happen, even through expert fiduciary SPV… https://t.co/sSiVfsc3cF",2999,214,3213,2018-08-25
439,1033261623060783104,Sat Aug 25 07:55:42 +0000 2018,"@ElectrekCo @FredericLambert The extension cord was 1000 miles long, but still",2161,98,2259,2018-08-25
440,1033260379147620352,Sat Aug 25 07:50:46 +0000 2018,@ElectrekCo @FredericLambert What’s cool is that it was driven across the country alone (no escort or any accompany… https://t.co/JJgtGj1N4Z,9685,656,10341,2018-08-25
441,1033229945382858753,Sat Aug 25 05:49:50 +0000 2018,"@Tesla In talking to our public investors, most were supportive of optimizing for long-term value creation over qua… https://t.co/Sk4XcIqSD0",13906,988,14894,2018-08-25
442,1033222340388089856,Sat Aug 25 05:19:36 +0000 2018,RT @Tesla: Staying Public https://t.co/gUrAnInBOu,0,5588,5588,2018-08-25
443,1033203657137745920,Sat Aug 25 04:05:22 +0000 2018,@nichegamer It’s almost done,3291,920,4211,2018-08-25
444,1033203405223735297,Sat Aug 25 04:04:22 +0000 2018,"@isco__ Yes 😀🖤🚀, looks brutal otherwise",1164,34,1198,2018-08-25
445,1033202742808834048,Sat Aug 25 04:01:44 +0000 2018,This is actually real https://t.co/I5wZrqYoCW,32875,2952,35827,2018-08-25
446,1033202579214192640,Sat Aug 25 04:01:05 +0000 2018,"This time, the vacuum tunnel will be a bit longer &amp; SpaceX will provide some advance funding for student teams with… https://t.co/ZtIkF5nZZ5",11443,1346,12789,2018-08-25
447,1033163788105596928,Sat Aug 25 01:26:56 +0000 2018,"RT @LenosGarage: 3 motors.
10,000Nm of torque.
Top speed of 250+ mph.

The 2020 Tesla Roadster is more like a fighter plane. #JayLenosGarag…",0,4928,4928,2018-08-25
448,1032977253297057792,Fri Aug 24 13:05:43 +0000 2018,"@AshleyEsqueda Tesla Car Karaoke hopefully ready in OTA software update version 10. Just played Missile Command, As… https://t.co/EoXG4MzNO0",12090,696,12786,2018-08-24
449,1032805107157618689,Fri Aug 24 01:41:40 +0000 2018,@ElectrekCo I was just there. Cardboard being prepped for recycling along southern fence line caught fire. Super ap… https://t.co/MrWAzWPGlv,12805,600,13405,2018-08-24
450,1032804122330845184,Fri Aug 24 01:37:45 +0000 2018,"Goal is to service your car wherever you are, quietly &amp; quickly. No need to bring it to a Tesla service center. https://t.co/KCIFtliZr8",47388,5311,52699,2018-08-24
451,1032575787340189696,Thu Aug 23 10:30:26 +0000 2018,@Model3Owners Ok,3783,116,3899,2018-08-23
452,1032575096701906944,Thu Aug 23 10:27:42 +0000 2018,"Love born in the brain is more spirited, doubtless, than true love, but it has only flashes of enthusiasm; it knows… https://t.co/XNTiYEMNmI",37570,5531,43101,2018-08-23
453,1032568982836928512,Thu Aug 23 10:03:24 +0000 2018,@VoxPolitico So many saved drafts. So … so many.,1715,76,1791,2018-08-23
454,1032561259655323648,Thu Aug 23 09:32:43 +0000 2018,@VoxPolitico I’m dying to,16459,663,17122,2018-08-23
455,1032421611742191617,Thu Aug 23 00:17:48 +0000 2018,"@tldtoday @Tesla Cool, lmk if you have suggestions for improvement after you drive it",3460,85,3545,2018-08-23
456,1032419173706563584,Thu Aug 23 00:08:07 +0000 2018,@CathieDWood Thank you for the thoughtful letter,3050,123,3173,2018-08-23
457,1032411200213024769,Wed Aug 22 23:36:26 +0000 2018,@tldtoday @Tesla Thanks for buying our car! Would highly recommend performance version. It’s really good &amp; I don’t… https://t.co/rs1UQ3wLay,10285,349,10634,2018-08-22
458,1032285070449467393,Wed Aug 22 15:15:14 +0000 2018,@Teslatunity @Tesla Coming soon,680,31,711,2018-08-22
459,1032131349505699840,Wed Aug 22 05:04:24 +0000 2018,@LittleMissFlint Definitely,1137,14,1151,2018-08-22
460,1032042656040251392,Tue Aug 21 23:11:58 +0000 2018,https://t.co/Q9JE06lmWN,42097,2905,45002,2018-08-21
461,1031969283612397569,Tue Aug 21 18:20:24 +0000 2018,"@wuhfel Instagram is so thirsty, yet gives you Death by Water",1039,188,1227,2018-08-21
462,1031960174574161920,Tue Aug 21 17:44:13 +0000 2018,@wuhfel Didn’t “like” it,809,65,874,2018-08-21
463,1031959950870945793,Tue Aug 21 17:43:19 +0000 2018,Really makes me wanna buy Rice Krispies https://t.co/PEVjRe4YnU,18082,2382,20464,2018-08-21
464,1031959325240111106,Tue Aug 21 17:40:50 +0000 2018,@AlexanderPayton Excession,431,18,449,2018-08-21
465,1031936103891140608,Tue Aug 21 16:08:34 +0000 2018,Read Eliot’s notes on The Waste Land https://t.co/2SSsHiJmiO https://t.co/uToAi4kBi1,5703,621,6324,2018-08-21
466,1031684325048168448,Mon Aug 20 23:28:05 +0000 2018,RT @MKBHD: NEW VIDEO - Tesla Factory Tour with Elon Musk! https://t.co/JwlED0vP3s - RT! https://t.co/NEt90rFzbu,0,3711,3711,2018-08-20
467,1031258020548771840,Sun Aug 19 19:14:06 +0000 2018,@O_Landman @Tesla Version 10,1241,101,1342,2018-08-19
468,1031111742103814144,Sun Aug 19 09:32:51 +0000 2018,@ariannahuff Ford &amp; Tesla are the only 2 American car companies to avoid bankruptcy. I just got home from the facto… https://t.co/KQ1dOYjKlW,43202,3892,47094,2018-08-19
469,1030735648171282433,Sat Aug 18 08:38:23 +0000 2018,Super appreciate free concert for Tesla during this intense time! 🖤🖤 https://t.co/bHCofIaReS,21180,1212,22392,2018-08-18
470,1030632127870599168,Sat Aug 18 01:47:02 +0000 2018,Great meeting you! https://t.co/Z16NK3GuXp,83295,6000,89295,2018-08-18
471,1030237322694934528,Thu Aug 16 23:38:13 +0000 2018,@StephenNellis @Tesla Nvidia makes great hardware. High respect for Jensen &amp; company. Our hardware needs were just… https://t.co/dXhcqpQfgp,6652,340,6992,2018-08-16
472,1029947219573702656,Thu Aug 16 04:25:27 +0000 2018,Model 3 review by Unbox ... https://t.co/UeA9MXyva1 via @YouTube,12181,1414,13595,2018-08-16
473,1029939331736072192,Thu Aug 16 03:54:06 +0000 2018,@BSaiHemanth Missile Command &amp; Lunar Lander already working in dev build. We changed the control mapping for max fun on a touchscreen.,987,58,1045,2018-08-16
474,1029938219125694464,Thu Aug 16 03:49:41 +0000 2018,Defeating traffic is the ultimate boss battle,101187,13324,114511,2018-08-16
475,1029936646555234306,Thu Aug 16 03:43:26 +0000 2018,RT @MayorOfLA: Always exciting to see innovative ideas like the proposed Dugout Loop to @Dodgers Stadium that could help ease congestion on…,0,436,436,2018-08-16
476,1029935349336666112,Thu Aug 16 03:38:17 +0000 2018,"RT @boringcompany: The Boring Company is excited to announce Dugout Loop – a high-speed, zero-emissions, underground public transportation…",0,2223,2223,2018-08-16
477,1029862136439160832,Wed Aug 15 22:47:21 +0000 2018,RT @SpaceX: Falcon 9 lands on the “Of Course I Still Love You” droneship and returns to port after delivering the Merah Putih satellite to…,0,3859,3859,2018-08-15
478,1029513981646450689,Tue Aug 14 23:43:55 +0000 2018,RT @Commercial_Crew: Hear from the five astronauts who will be the first fly @boeingspace's Starliner and @SpaceX's Crew Dragon to the Inte…,0,843,843,2018-08-14
479,1029268695615340546,Tue Aug 14 07:29:14 +0000 2018,RT @boringcompany: We are hosting student tours of the Hawthorne tunnel site for schools in LA County! Each tour can accommodate up to 30 s…,0,640,640,2018-08-14
480,1029238844443439111,Tue Aug 14 05:30:37 +0000 2018,@MacTechGenius @kaushal_k @kevinmitnick Blue too,837,72,909,2018-08-14
481,1029236837083009025,Tue Aug 14 05:22:38 +0000 2018,@kaushal_k @kevinmitnick Hex nostalgia,758,72,830,2018-08-14
482,1029235533396860928,Tue Aug 14 05:17:28 +0000 2018,@kevinmitnick 49 20 77 61 73 2e 20 53 6f 72 72 79 20 74 6f 20 68 61 76 65 20 6d 69 73 73 65 64 20 79 6f 75 2e,7374,534,7908,2018-08-14
483,1029231367664484352,Tue Aug 14 05:00:54 +0000 2018,RT @SpaceX: The first four @NASA astronauts who will fly aboard Crew Dragon visited the factory to meet employees today. https://t.co/MLGrh…,0,2909,2909,2018-08-14
484,1029171381584314368,Tue Aug 14 01:02:33 +0000 2018,"@Tesla I’m excited to work with Silver Lake and Goldman Sachs as financial advisors, plus Wachtell, Lipton, Rosen &amp;… https://t.co/MrXU5ULvOu",13228,1325,14553,2018-08-14
485,1029016696193863680,Mon Aug 13 14:47:53 +0000 2018,@amitkatwala @WiredUK Open to it at some point. You did an impressive amount of work on this article.,1200,34,1234,2018-08-13
486,1029001597982928898,Mon Aug 13 13:47:53 +0000 2018,"@amitkatwala @WiredUK Mostly accurate, even though I didn’t do an interview (or pose for cover)",9358,444,9802,2018-08-13
487,1028985700459339776,Mon Aug 13 12:44:43 +0000 2018,@physorg_com @ETH_en @PNASNews ETH beam heh heh,1301,70,1371,2018-08-13
488,1028983518183837696,Mon Aug 13 12:36:02 +0000 2018,"@Josh1C Good idea, we will add this feature!",6199,116,6315,2018-08-13
489,1028773837557649410,Sun Aug 12 22:42:51 +0000 2018,Model 3 traction testing on pure ice &amp; snow https://t.co/knIg6JMNHO,32499,3323,35822,2018-08-12
490,1028351047478042624,Sat Aug 11 18:42:50 +0000 2018,Great Q&amp;A @defcon last night. Thanks for helping make Tesla &amp; SpaceX more secure! Planning to open-source Tesla veh… https://t.co/FuJqake7Ew,25228,3722,28950,2018-08-11
491,1028349398546231296,Sat Aug 11 18:36:17 +0000 2018,"@momof3terrors Thanks, great feedback. Will be a fun  project for Tesla design. Love the idea of adding a special i… https://t.co/ckQR4GHPCr",675,30,705,2018-08-11
492,1028335775480332289,Sat Aug 11 17:42:09 +0000 2018,"@FredericLambert @woodhaus2 Production design will be better, especially in details. We are dying to do this, but p… https://t.co/4O8hIvNGQz",7575,414,7989,2018-08-11
493,1028146651268087809,Sat Aug 11 05:10:38 +0000 2018,@Photofeature He was amazing,575,11,586,2018-08-11
494,1028141920399306752,Sat Aug 11 04:51:50 +0000 2018,@PrydeFoltz Not if you had a wide elastic at the top,583,10,593,2018-08-11
495,1028139797649469440,Sat Aug 11 04:43:24 +0000 2018,@ShorealoneFilms Busted,1950,136,2086,2018-08-11
496,1028139236548128768,Sat Aug 11 04:41:10 +0000 2018,And thigh high socks with pockets for lipliner &amp; cards,46047,4316,50363,2018-08-11
497,1028132430992105472,Sat Aug 11 04:14:07 +0000 2018,@KiannaFierce Of course,910,34,944,2018-08-11
498,1028132035720880129,Sat Aug 11 04:12:33 +0000 2018,Unis3x,11850,1093,12943,2018-08-11
499,1028131675602079747,Sat Aug 11 04:11:07 +0000 2018,Paired with thigh-high sockboots,12531,1156,13687,2018-08-11
500,1028129215059828737,Sat Aug 11 04:01:21 +0000 2018,What are your fav short shorts?,11316,1124,12440,2018-08-11
501,1028126594425081863,Sat Aug 11 03:50:56 +0000 2018,S3XY,36594,8497,45091,2018-08-11
502,1028121465785405441,Sat Aug 11 03:30:33 +0000 2018,Short shorts coming soon to Tesla merch,109127,17293,126420,2018-08-11
503,1028119241025904640,Sat Aug 11 03:21:43 +0000 2018,@davidein Put them on &amp; post a selfie,3837,212,4049,2018-08-11
504,1028074217793679360,Sat Aug 11 00:22:48 +0000 2018,.@defcon. hqr sz wut.,8919,1171,10090,2018-08-11
505,1028028506091872257,Fri Aug 10 21:21:10 +0000 2018,RT @Tesla: 99% of the US population is within 150 miles of a Supercharger https://t.co/AbUNtEMzzC,0,2034,2034,2018-08-10
506,1028016698924793856,Fri Aug 10 20:34:15 +0000 2018,@thesheetztweetz @Chubbies @davidein @khency6 @CNBC Awesome 🤣,740,35,775,2018-08-10
507,1027798878962081793,Fri Aug 10 06:08:42 +0000 2018,"@JohnnaSabri @Medium Love this from P&amp;P: “One has got all the goodness, and the other all the appearance of it.” Re… https://t.co/xP7bjkytVr",3574,170,3744,2018-08-10
508,1027782177721790465,Fri Aug 10 05:02:21 +0000 2018,@SpaceXUpdates Those are the new design made of titanium. Doesn’t need heat shielding or even paint.,4822,226,5048,2018-08-10
509,1027643485241974785,Thu Aug 09 19:51:14 +0000 2018,RT @Model3Owners: Free trial of Autopilot for those who haven’t purchased it is starting to roll out. 14 days to decide if you want it or n…,0,706,706,2018-08-09
510,1027316549697253377,Wed Aug 08 22:12:06 +0000 2018,"@lexiheft @FredericLambert @lexfridman Sorry, meant to say same timeframe as hardware",634,98,732,2018-08-08
511,1027315863454593025,Wed Aug 08 22:09:23 +0000 2018,@komocode @FredericLambert @lexfridman Yes,526,15,541,2018-08-08
512,1027315193070534657,Wed Aug 08 22:06:43 +0000 2018,RT @FredericLambert: It appears that there's overwhelming support from @ElectrekCo readers for @elonmusk's plan to take @Tesla private: htt…,0,646,646,2018-08-08
513,1027314633101598721,Wed Aug 08 22:04:29 +0000 2018,@FredericLambert @lexfridman Probably 4 to 6 months. Those who order full self-driving get the upgrade at no cost.… https://t.co/ryB29jUJHO,1051,123,1174,2018-08-08
514,1027294935504936960,Wed Aug 08 20:46:13 +0000 2018,Tesla deliveries &amp; AP hardware chart by @lexfridman at MIT https://t.co/6vZxKMcec2,11705,1306,13011,2018-08-08
515,1026914941004001280,Tue Aug 07 19:36:15 +0000 2018,Investor support is confirmed. Only reason why this is not certain is that it’s contingent on a shareholder vote. https://t.co/bIH4Td5fED,19711,2958,22669,2018-08-07
516,1026908295154397184,Tue Aug 07 19:09:51 +0000 2018,RT @elonmusk: @MindFieldMusic Def no forced sales. Hope all shareholders remain. Will be way smoother &amp; less disruptive as a private compan…,0,732,732,2018-08-07
517,1026907699760390146,Tue Aug 07 19:07:29 +0000 2018,@MindFieldMusic Def no forced sales. Hope all shareholders remain. Will be way smoother &amp; less disruptive as a priv… https://t.co/CSpYLGDYIL,7898,732,8630,2018-08-07
518,1026906046839672832,Tue Aug 07 19:00:55 +0000 2018,"@thatspacegeek Yes, but liquidity events would be limited to every 6 months or so (like SpaceX)",1815,112,1927,2018-08-07
519,1026900423247101952,Tue Aug 07 18:38:34 +0000 2018,RT @elonmusk: @heydave7 Absolutely. Am super appreciative of Tesla shareholders. Will ensure their prosperity in any scenario.,0,522,522,2018-08-07
520,1026894478764851202,Tue Aug 07 18:14:57 +0000 2018,@FredericLambert No change,1402,54,1456,2018-08-07
521,1026894228541071360,Tue Aug 07 18:13:57 +0000 2018,Shareholders could either to sell at 420 or hold shares &amp; go private,19520,2221,21741,2018-08-07
522,1026892550337122304,Tue Aug 07 18:07:17 +0000 2018,@heydave7 Absolutely. Am super appreciative of Tesla shareholders. Will ensure their prosperity in any scenario.,7187,522,7709,2018-08-07
523,1026891706879430656,Tue Aug 07 18:03:56 +0000 2018,RT @elonmusk: @Gfilche My hope is *all* current investors remain with Tesla even if we’re private. Would create special purpose fund enabli…,0,985,985,2018-08-07
524,1026890900885184514,Tue Aug 07 18:00:44 +0000 2018,@Gfilche My hope is *all* current investors remain with Tesla even if we’re private. Would create special purpose f… https://t.co/Jj1hlndG7h,8972,985,9957,2018-08-07
525,1026888063899774976,Tue Aug 07 17:49:27 +0000 2018,@EvotoRentals Yes,2265,59,2324,2018-08-07
526,1026885883482365953,Tue Aug 07 17:40:47 +0000 2018,@FredericLambert I don’t have a controlling vote now &amp; wouldn’t expect any shareholder to have one if we go private… https://t.co/xvx0M3jWIJ,1692,160,1852,2018-08-07
527,1026882735455916032,Tue Aug 07 17:28:17 +0000 2018,Good morning 😀,50329,3540,53869,2018-08-07
528,1026879404905885697,Tue Aug 07 17:15:03 +0000 2018,@LizClaman @Tesla 420,6747,1002,7749,2018-08-07
529,1026872652290379776,Tue Aug 07 16:48:13 +0000 2018,Am considering taking Tesla private at $420. Funding secured.,88738,16354,105092,2018-08-07
530,1026601975599648768,Mon Aug 06 22:52:38 +0000 2018,RT @arstechnica: #SpaceX wants to re-fly a Block 5 rocket for the first time tonight—the two-hour launch window opens at 1:18am ET Tuesday…,0,593,593,2018-08-06
531,1026583435278577664,Mon Aug 06 21:38:58 +0000 2018,"RT @SpaceX: Falcon 9 and Merah Putih are vertical on Pad 40 in Florida. Weather is 80% favorable for the two-hour launch window, which open…",0,2764,2764,2018-08-06
532,1026583393243344896,Mon Aug 06 21:38:48 +0000 2018,RT @SpaceX: Dragon returned home yesterday after its second month-long stay at the @Space_Station. It’s now headed to port for a cargo hand…,0,2648,2648,2018-08-06
533,1026539075648385024,Mon Aug 06 18:42:42 +0000 2018,"RT @Tesla: .@jalopnik reviews Model 3 Performance
https://t.co/Vejb9fTY5Q",0,529,529,2018-08-06
534,1026266053658038272,Mon Aug 06 00:37:48 +0000 2018,@ChillinQuillen @joerogan Maybe Thursday,1381,119,1500,2018-08-06
535,1026262681848709120,Mon Aug 06 00:24:25 +0000 2018,That’s right provided the two Crew Dragon test flights go well. Hardware will def be ready. https://t.co/KcAFArYn1x,14315,1675,15990,2018-08-06
536,1026257578920009730,Mon Aug 06 00:04:08 +0000 2018,@gdb @OpenAI @Blitz_DotA Great work by @OpenAI. Need the neural interface soon to enable human/AI symbiosis.,1159,143,1302,2018-08-06
537,1026250770235023360,Sun Aug 05 23:37:05 +0000 2018,@Excellion We’re working on a new Tesla mini-car that can squeeze in an adult,879,94,973,2018-08-05
538,1026231822122770432,Sun Aug 05 22:21:47 +0000 2018,@Khoji Yes,294,10,304,2018-08-05
539,1026229874548043776,Sun Aug 05 22:14:03 +0000 2018,"@Rengle820 Model S P100D is def still the top end, but Model 3 Performance is higher value for money",504,35,539,2018-08-05
540,1026209310634700800,Sun Aug 05 20:52:20 +0000 2018,RT @Scobleizer: @NeilHUSA @elonmusk Not true. With three kids in the car you need to stop every three hours for bathroom and food anyway. C…,0,324,324,2018-08-05
541,1026208127128035328,Sun Aug 05 20:47:38 +0000 2018,"@lexiheft Early access will have bugs (usually minor, but you never know for sure), so would not advise early acces… https://t.co/2eiOMtjCNh",541,16,557,2018-08-05
542,1026204484421074944,Sun Aug 05 20:33:09 +0000 2018,@Scobleizer 🖤 Tesla Autopilot Team 🖤,932,46,978,2018-08-05
543,1026203902155218944,Sun Aug 05 20:30:50 +0000 2018,@vicentes @vishaljotshi Everywhere …,417,11,428,2018-08-05
544,1026203726371934208,Sun Aug 05 20:30:08 +0000 2018,@LanceUlanoff @vishaljotshi Much more interesting,372,11,383,2018-08-05
545,1026203526332989441,Sun Aug 05 20:29:21 +0000 2018,"@chriscardinal Games &amp; other refinements will go to all Tesla S, X &amp; 3 from start of production. Autopilot enhancem… https://t.co/VU6mavEv0r",529,34,563,2018-08-05
546,1026202323775672320,Sun Aug 05 20:24:34 +0000 2018,Glad you’re enjoying Model 3 &amp; thanks for buying a Tesla! Major enhancements to Autopilot &amp; fun games coming in a m… https://t.co/dnCzWK3KuC,9531,642,10173,2018-08-05
547,1026201140378009600,Sun Aug 05 20:19:52 +0000 2018,@vishaljotshi Yup,1013,26,1039,2018-08-05
548,1026193065034149888,Sun Aug 05 19:47:47 +0000 2018,@MatthewTBishop @mattdebord Def worth it. Model 3 Performance is next-level.,1021,54,1075,2018-08-05
549,1026191962926280704,Sun Aug 05 19:43:24 +0000 2018,"@bbccomedy @BoycottStuff 🖤 Tracey “… before I knew it, I was writing to The Guardian …” 🤣🤣🤣",466,19,485,2018-08-05
550,1026189335668781056,Sun Aug 05 19:32:57 +0000 2018,@marks22 Thanks for the tip. His attention to detail is excellent.,430,14,444,2018-08-05
551,1026189082882260992,Sun Aug 05 19:31:57 +0000 2018,@JmChile @OpenAI The humans,3712,217,3929,2018-08-05
552,1026188902522966016,Sun Aug 05 19:31:14 +0000 2018,Love The Handmaiden. Director also made original Korean Oldboy. https://t.co/FtXqNflQlr,4425,323,4748,2018-08-05
553,1026185672468512773,Sun Aug 05 19:18:24 +0000 2018,@WorldAndScience Very tiny,8150,391,8541,2018-08-05
554,1026164075900727296,Sun Aug 05 17:52:35 +0000 2018,Performance Model 3 review by @mattdebord https://t.co/uEA599VPcX,6829,734,7563,2018-08-05
555,1026073171638738944,Sun Aug 05 11:51:22 +0000 2018,"Dang, turns out even Hitler was shorting Tesla stock … https://t.co/RLM1VQ5O3K",19127,2909,22036,2018-08-05
556,1025788954707030016,Sat Aug 04 17:01:59 +0000 2018,Still as true today as it was 6 years ago,12361,482,12843,2018-08-04
557,1025788479483961350,Sat Aug 04 17:00:06 +0000 2018,Squirrels … https://t.co/sVegPxD046,16948,1378,18326,2018-08-04
558,1025378386716241920,Fri Aug 03 13:50:32 +0000 2018,RT @Space_Station: Station teams from around the world polled “go” for Friday’s release of the @SpaceX #Dragon cargo craft and its splashdo…,0,776,776,2018-08-03
559,1025377867532627968,Fri Aug 03 13:48:28 +0000 2018,RT @Tesla: Tesla Grid Controller and Powerpacks optimize renewable energy across Samoa’s grid https://t.co/yhu738mRt0 https://t.co/w2TpAAaH…,0,1049,1049,2018-08-03
560,1025138553867534337,Thu Aug 02 21:57:32 +0000 2018,@DMC_Ryan Will work with current hardware. OTA update.,597,29,626,2018-08-02
561,1025134835226959872,Thu Aug 02 21:42:45 +0000 2018,RT @Tesla: Gigafactory 1 battery production has reached an annualized run rate of ≈20 GWh - more kWh than all other carmakers combined http…,0,2652,2652,2018-08-02
562,1024765359339974656,Wed Aug 01 21:14:35 +0000 2018,RT @SpaceX: Dragon and the @Space_Station passed over SpaceX headquarters and across the face of the Moon last weekend. After a month-long…,0,2415,2415,2018-08-01
563,1024761320392904704,Wed Aug 01 20:58:32 +0000 2018,@BrouardMartin @atari Definitely,594,17,611,2018-08-01
564,1024760547059818497,Wed Aug 01 20:55:28 +0000 2018,@scoti5 @levine Bioshock is amazing,1090,163,1253,2018-08-01
565,1024759651668123649,Wed Aug 01 20:51:54 +0000 2018,"@SadCookieCrisp Something like that, but more of an adults in cars anime vibe",4739,677,5416,2018-08-01
566,1024758658251411456,Wed Aug 01 20:47:57 +0000 2018,Please send examples of prior work when applying. Looking for max playability &amp; creativity.,18044,1183,19227,2018-08-01
567,1024758123406323712,Wed Aug 01 20:45:50 +0000 2018,"If you’re into video game development, consider applying to Tesla. We want to make super fun games that integrate t… https://t.co/MZcsHs5D8s",79070,12642,91712,2018-08-01
568,1024756440366370816,Wed Aug 01 20:39:09 +0000 2018,@BlacklistTrader 😛,519,19,538,2018-08-01
569,1024756316466688000,Wed Aug 01 20:38:39 +0000 2018,@MobiiliMika @atari Cool idea!,603,15,618,2018-08-01
570,1024756088221007872,Wed Aug 01 20:37:45 +0000 2018,@Model3Owners @atari Good idea &amp; thanks for Supercharger trophy reminder. Really want to make the car as fun as possible!,871,46,917,2018-08-01
571,1024729113968271360,Wed Aug 01 18:50:33 +0000 2018,@megazone @RyanHummer @atari Yup,697,22,719,2018-08-01
572,1024728904412450816,Wed Aug 01 18:49:44 +0000 2018,"@jlgolson @atari Hoping to include last three in this release, with pole position linked to actual car steering whe… https://t.co/UJ7OO2nteL",2424,145,2569,2018-08-01
573,1024728178865008640,Wed Aug 01 18:46:51 +0000 2018,@RyanHummer @atari We will try to squeeze it in,877,18,895,2018-08-01
574,1024727291601928193,Wed Aug 01 18:43:19 +0000 2018,@jlgolson @atari What are your favorites?,927,25,952,2018-08-01
575,1024727040291831810,Wed Aug 01 18:42:19 +0000 2018,@austjennings Yes,1224,49,1273,2018-08-01
576,1024726957500522496,Wed Aug 01 18:41:59 +0000 2018,@nantonius @atari Yes,627,16,643,2018-08-01
577,1024726836352188417,Wed Aug 01 18:41:30 +0000 2018,@lexiheft @atari Yes,821,33,854,2018-08-01
578,1024726529304027137,Wed Aug 01 18:40:17 +0000 2018,Some of best classic @Atari games coming as Easter eggs in Tesla V9.0 release in about 4 weeks. Thanks @Atari!,35889,4155,40044,2018-08-01
579,1024672548313804800,Wed Aug 01 15:05:47 +0000 2018,Falcon 9 launches Iridium to orbit from Vandenberg Air Force Base https://t.co/7GTzx0a24d,8330,726,9056,2018-08-01
580,1024561920173457408,Wed Aug 01 07:46:11 +0000 2018,@tictoc Tragic. Will send Einhorn a box of short shorts to comfort him through this difficult time.,10648,728,11376,2018-08-01
581,1024555306112540673,Wed Aug 01 07:19:54 +0000 2018,@WorldAndScience And most of remaining 0.14% is Jupiter. We are tiny dust on tiny dust.,34591,2918,37509,2018-08-01
582,1024435601443966976,Tue Jul 31 23:24:15 +0000 2018,@DiscoverMag Science ♥️🔬💫 https://t.co/HIAnWrrZwM,912,92,1004,2018-07-31
583,1024434827158638592,Tue Jul 31 23:21:10 +0000 2018,@DiscoverMag Oh yeah? I’ll see ur expert &amp; raise you a Chris McKay @NASA 🌏🚀👨‍🔬 😀https://t.co/LEXPf93ryT,943,67,1010,2018-07-31
584,1024406801477816320,Tue Jul 31 21:29:48 +0000 2018,@aswhiting Tesla body shops are ramping up fast. Aiming to go from 30+ days using external body repair shops to sam… https://t.co/Lo1qg5hn3S,783,66,849,2018-07-31
585,1024364396674351104,Tue Jul 31 18:41:18 +0000 2018,@4NIKKOLAS @samir Will leave any comment on actions in Flint to those in Flint,600,28,628,2018-07-31
586,1024364000870420481,Tue Jul 31 18:39:44 +0000 2018,@iLehonardo Can’t wait to bring Tesla to Brazil. One of my favorite countries!,1262,129,1391,2018-07-31
587,1024363530395443200,Tue Jul 31 18:37:52 +0000 2018,@l9cgv We should be really worried about this,496,18,514,2018-07-31
588,1024363380771966976,Tue Jul 31 18:37:16 +0000 2018,@samir No,2682,435,3117,2018-07-31
589,1024363242057916416,Tue Jul 31 18:36:43 +0000 2018,"@AndredAlmeida Yeah, Model 3 is designed to fit 6’4”  adults comfortably in both front &amp; rear seats at same time",714,36,750,2018-07-31
590,1024362530691371008,Tue Jul 31 18:33:53 +0000 2018,"We’re adding a “party &amp; camper mode” soon to S/3/X, so your car can maintain air flow, temp, selective lights, musi… https://t.co/LustCdPBc5",21460,1743,23203,2018-07-31
591,1024360983970467840,Tue Jul 31 18:27:44 +0000 2018,"Not having a big gas guzzler engine in front means there’s room for trunks in front &amp; back, plus longer crumple zon… https://t.co/WeI9iTT2CB",19442,1504,20946,2018-07-31
592,1024190725255192578,Tue Jul 31 07:11:12 +0000 2018,@Tesla Hard drive industry is hardcore. They build &gt;100 million units per year with extreme precision &amp; brutal economics. Great background.,7862,371,8233,2018-07-31
593,1024137570463051778,Tue Jul 31 03:39:59 +0000 2018,@DiscoverMag There’s a massive amount of CO2 on Mars adsorbed into soil that’d be released upon heating. With enoug… https://t.co/e50VH0IiaP,30239,2639,32878,2018-07-31
594,1023808486226812933,Mon Jul 30 05:52:19 +0000 2018,"@jbaert Yes, minifloats",550,14,564,2018-07-30
595,1023786119895216128,Mon Jul 30 04:23:26 +0000 2018,@martinengwicht Yes,1033,24,1057,2018-07-30
596,1023779158030077952,Mon Jul 30 03:55:46 +0000 2018,"We tried out a new delivery system using an enclosed trailer straight from factory to owner’s home, so super conven… https://t.co/rZ3r0MSOKh",42479,3685,46164,2018-07-30
597,1023771444583399424,Mon Jul 30 03:25:07 +0000 2018,"@martinengwicht @Grimezsz Was listening to Jon Hopkins’ Singularity with c, but posted this instead",514,17,531,2018-07-30
598,1023754616192684040,Mon Jul 30 02:18:15 +0000 2018,https://t.co/PctxEIDekX,3289,251,3540,2018-07-30
599,1023749975065354240,Mon Jul 30 01:59:49 +0000 2018,"@Hussi_Tussi Have wanted to for so long, but that would be irresponsible",529,11,540,2018-07-30
600,1023749689701593088,Mon Jul 30 01:58:41 +0000 2018,@KingTer74261333 @neuralink All are important. You will see.,677,40,717,2018-07-30
601,1023748634242772992,Mon Jul 30 01:54:29 +0000 2018,8-bit floating point?,9691,614,10305,2018-07-30
602,1023728298226999296,Mon Jul 30 00:33:40 +0000 2018,"@Mr_Computique If any formula instantiates reality, it’s probably that",355,17,372,2018-07-30
603,1023683692605005824,Sun Jul 29 21:36:26 +0000 2018,"Think once, Tweet twice [do it]",39178,5385,44563,2018-07-29
604,1023675534553698304,Sun Jul 29 21:04:01 +0000 2018,0,19342,1760,21102,2018-07-29
605,1023674091142701056,Sun Jul 29 20:58:16 +0000 2018,Nothing is both real &amp; imaginary,52811,10104,62915,2018-07-29
606,1023661157247201280,Sun Jul 29 20:06:53 +0000 2018,@J_M_0_N @Tesla Yes,945,62,1007,2018-07-29
607,1023649332023582720,Sun Jul 29 19:19:53 +0000 2018,The future is accelerating https://t.co/hKXFJtV8Wt,11044,1505,12549,2018-07-29
608,1023640028193255425,Sun Jul 29 18:42:55 +0000 2018,@fermatslibrary 😱,1640,68,1708,2018-07-29
609,1023073822080098304,Sat Jul 28 05:13:01 +0000 2018,@SmileSimplify @EmreKelly @nextspaceflight Probably ships next summer,619,32,651,2018-07-28
610,1023069021057380353,Sat Jul 28 04:53:56 +0000 2018,"@nextspaceflight Side boosters, yes, but too much load through center core",771,38,809,2018-07-28
611,1023067599528124416,Sat Jul 28 04:48:18 +0000 2018,🖤🚀💫 https://t.co/HPu4SfoM0P,11586,889,12475,2018-07-28
612,1023061301273055232,Sat Jul 28 04:23:16 +0000 2018,@ElectrekCo @FredericLambert This is great.,7144,300,7444,2018-07-28
613,1022914284857085953,Fri Jul 27 18:39:04 +0000 2018,RT @SpaceX: More photos from Falcon 9’s launch of Iridium-7 → https://t.co/095WHX44BX https://t.co/JG0qyiajb7,0,3079,3079,2018-07-27
614,1022914062009556992,Fri Jul 27 18:38:11 +0000 2018,@phil_hellmuth @Tesla Thanks Phil,3131,62,3193,2018-07-27
615,1022883831173398528,Fri Jul 27 16:38:04 +0000 2018,@AlexGarnerArt @WhatTheFFacts Machines that go “ping”,1592,53,1645,2018-07-27
616,1022879510239170560,Fri Jul 27 16:20:54 +0000 2018,@WhatTheFFacts What’s technology?,10962,576,11538,2018-07-27
617,1022430321696858113,Thu Jul 26 10:35:59 +0000 2018,"Worth another retweet. Hope Dan Neil returns to Twitter. He left due to relentless attacks from short-sellers, who… https://t.co/gKb2aU5E43",23583,3003,26586,2018-07-26
618,1022418419667226624,Thu Jul 26 09:48:41 +0000 2018,@westcoastbill Explains why there are so many cat videos,6485,331,6816,2018-07-26
619,1022218032741900288,Wed Jul 25 20:32:25 +0000 2018,"RT @iambhutia: Cynics said it can’t be done.
Now @Tesla powerpacks aiding #Samoa transition to 💯 % renewable energy.

@IMI_Info @icimod @ZW…",0,833,833,2018-07-25
620,1022217710040543232,Wed Jul 25 20:31:08 +0000 2018,@AntVenom @BBCBreaking Localized electro-magnetic field generators,940,47,987,2018-07-25
621,1022217288756289537,Wed Jul 25 20:29:28 +0000 2018,RT @spakkal: @elonmusk Oil Companies Reap Billions From Subsidies https://t.co/8Dkb67ToGh  @petenajarian @GerberKawasaki If 400Bill worldwi…,0,793,793,2018-07-25
622,1022159864427032576,Wed Jul 25 16:41:17 +0000 2018,"RT @BBCBreaking: Scientists believe they've found liquid water on Mars for the first time, a potential game-changer in the search for life…",0,10274,10274,2018-07-25
623,1022159242726232064,Wed Jul 25 16:38:48 +0000 2018,@IridiumBoss @SpaceX @Spotify @Marine_layer Thanks for taking a chance on @SpaceX so many years ago! Looking forwar… https://t.co/WS8H0VZx2m,3594,171,3765,2018-07-25
624,1022048284599148545,Wed Jul 25 09:17:54 +0000 2018,Wagnerian https://t.co/Mjt0bNCdIY,14017,941,14958,2018-07-25
625,1022030008724930565,Wed Jul 25 08:05:17 +0000 2018,@dflieb @Tesla Yes,6327,78,6405,2018-07-25
626,1022000378462855168,Wed Jul 25 06:07:32 +0000 2018,"Mötor Trēnd
https://t.co/jilxFHjkYW",14371,1506,15877,2018-07-25
627,1021616336798015488,Tue Jul 24 04:41:30 +0000 2018,@appljd Great!,634,21,655,2018-07-24
628,1021565852242464769,Tue Jul 24 01:20:53 +0000 2018,"RT @Tesla: 11,353 charging locations across the world and growing daily https://t.co/uNt2wUNT3c",0,1477,1477,2018-07-24
629,1021541242465730560,Mon Jul 23 23:43:06 +0000 2018,@appljd We’ve gone from ~1000 S/X deliveries per week in US last year to ~6000 S/3/X. It’s like hitting a square wave.,1143,104,1247,2018-07-23
630,1021529422224977920,Mon Jul 23 22:56:08 +0000 2018,"@appljd We’re trying to get rid of contracts completely. Should just be “tap here &amp; you get your car”. Then, if you… https://t.co/b1dT6skFbx",1130,97,1227,2018-07-23
631,1021461598508990464,Mon Jul 23 18:26:37 +0000 2018,@westcoastbill Yeah. Never seen it so high ever.,1582,61,1643,2018-07-23
632,1021461084585299973,Mon Jul 23 18:24:35 +0000 2018,"@WillFealey @Tesla @TeslaOwnersUK Wow, that’s really awesome. Thank you! ♥️@TeslaOwnersUK",3548,147,3695,2018-07-23
633,1021306180449099776,Mon Jul 23 08:09:03 +0000 2018,@arstechnica Haha,4639,336,4975,2018-07-23
634,1021288692655067136,Mon Jul 23 06:59:33 +0000 2018,"@nextspaceflight @ElectrekCo Looks good, but so many details need to be right. Journey back from hypersonic becomes… https://t.co/hop4zOQ1lD",852,48,900,2018-07-23
635,1021285179178881025,Mon Jul 23 06:45:35 +0000 2018,@ElectrekCo Only costs that actually apply to Q3 &amp; beyond will be counted. It would not be correct to apply histori… https://t.co/GbfVkAYWFF,2757,149,2906,2018-07-23
636,1021263722944217093,Mon Jul 23 05:20:20 +0000 2018,Wall Street https://t.co/gvZyxMwO5m,13813,1401,15214,2018-07-23
637,1021254856261058562,Mon Jul 23 04:45:06 +0000 2018,@Hyperloop @SpaceX Congratulations to all teams in the student @Hyperloop competition! To make high-speed pods that… https://t.co/LAS1OucY6X,2524,153,2677,2018-07-23
638,1021209558629285888,Mon Jul 23 01:45:06 +0000 2018,RT @Hyperloop: Congratulations to @WARR_Hyperloop for winning the 2018 Hyperloop Pod Competition with a peak speed of 290 mph!,0,911,911,2018-07-23
639,1020837172834906118,Sun Jul 22 01:05:22 +0000 2018,"@huby @87spider @ryan_caldbeck @Tesla Exactly. Overheat protection is always on, but you can also tap “maintain” &amp;… https://t.co/p9NoG9K6cg",763,49,812,2018-07-22
640,1020835959833677824,Sun Jul 22 01:00:33 +0000 2018,RT @SpaceX: Falcon 9 and Telstar 19 VANTAGE went vertical this afternoon on Pad 40 in Florida. Weather is 60% favorable for the four-hour l…,0,1653,1653,2018-07-22
641,1020797949297582080,Sat Jul 21 22:29:31 +0000 2018,"@ryan_caldbeck @Tesla Yes, Tesla Model S, X &amp; 3 all automatically keep cabin temperature within safe limits even wh… https://t.co/slP0GUtlS9",10448,987,11435,2018-07-21
642,1020601846275031040,Sat Jul 21 09:30:16 +0000 2018,RT @MKBHD: For those who were waiting - New on IGTV: Driving Tesla Model 3 Performance! https://t.co/SYRl4E9Vue https://t.co/8Il4tloamY,0,861,861,2018-07-21
643,1020544810095063041,Sat Jul 21 05:43:38 +0000 2018,@danfromtheweb Ok,718,14,732,2018-07-21
644,1020522855014924288,Sat Jul 21 04:16:23 +0000 2018,"@AntVenom @Ca_via_GreenBay Makes me very sad indeed, but also the fault is mine by far",1210,35,1245,2018-07-21
645,1020519836915396608,Sat Jul 21 04:04:24 +0000 2018,@AntVenom He’s a good guy,876,13,889,2018-07-21
646,1020518346754646016,Sat Jul 21 03:58:28 +0000 2018,@Ca_via_GreenBay Always look on the bright side of life …,1910,126,2036,2018-07-21
647,1020516593321701377,Sat Jul 21 03:51:30 +0000 2018,@AntVenom It is much better,1076,23,1099,2018-07-21
648,1020515232358121473,Sat Jul 21 03:46:06 +0000 2018,@JD_2020 Sorry 🤗,802,15,817,2018-07-21
649,1020514710549028864,Sat Jul 21 03:44:01 +0000 2018,https://t.co/ys9qlwcnpc,5315,265,5580,2018-07-21
650,1020513697121398784,Sat Jul 21 03:40:00 +0000 2018,"🦄💨✌️
https://t.co/8GjqCbsuo0",5645,297,5942,2018-07-21
651,1020508884199444480,Sat Jul 21 03:20:52 +0000 2018,@MitchellRossman @danfromtheweb I love that scene,730,5,735,2018-07-21
652,1020507170608230401,Sat Jul 21 03:14:04 +0000 2018,@danfromtheweb I made that up tbh. They did not have phones during the French Revolution. They used Friendster.,1945,50,1995,2018-07-21
653,1020504845495697408,Sat Jul 21 03:04:49 +0000 2018,@danfromtheweb Don’t make me bite my thumb at you,4284,166,4450,2018-07-21
654,1020504246620426240,Sat Jul 21 03:02:27 +0000 2018,@JaneidyEve For sure,882,26,908,2018-07-21
655,1020503572562219008,Sat Jul 21 02:59:46 +0000 2018,"@danfromtheweb Btw, 1792 is calling &amp; wants its method of execution back. Seriously, what museum do you plan to raid?",6554,292,6846,2018-07-21
656,1020498155413024768,Sat Jul 21 02:38:14 +0000 2018,"@annerajb @boringcompany Yeah, great point. Underground power lines would clear up the skyline, be safer to service… https://t.co/kKo4BQfJhR",781,31,812,2018-07-21
657,1020491376104898562,Sat Jul 21 02:11:18 +0000 2018,No kidding https://t.co/Vz3FdEO7Ud,25109,3330,28439,2018-07-21
658,1020479995028754432,Sat Jul 21 01:26:05 +0000 2018,"@annerajb @danfromtheweb Yes, that will probably be its first use",657,20,677,2018-07-21
659,1020479409805877248,Sat Jul 21 01:23:45 +0000 2018,"@danfromtheweb Phew 😅. Yeah, we had a drain block 3 months ago &amp; people are working hard to make Tesla successful.… https://t.co/mPSndrlmcu",1401,30,1431,2018-07-21
660,1020459692705775617,Sat Jul 21 00:05:24 +0000 2018,@danfromtheweb I apologized. Do you stand by your guillotine statement or not?,1227,23,1250,2018-07-21
661,1020455936396152832,Fri Jul 20 23:50:29 +0000 2018,"@danfromtheweb Figuratively, literally or both?",5973,158,6131,2018-07-20
662,1020404811307479040,Fri Jul 20 20:27:19 +0000 2018,@geekypastimes That has always been our goal,964,48,1012,2018-07-20
663,1020395545255276544,Fri Jul 20 19:50:30 +0000 2018,"@annerajb @Flyfiddlesticks @patrickc @stevesi This chart only shows globally competed commercial launches, not US g… https://t.co/ttZevtjdSC",1228,60,1288,2018-07-20
664,1020108713061855233,Fri Jul 20 00:50:44 +0000 2018,"@vincent13031925 @bonnienorman @Jason @scottwww Dunno where this bs is coming from. Who knows about the future, but… https://t.co/5pu1UQboJc",7360,589,7949,2018-07-20
665,1020107968589676545,Fri Jul 20 00:47:47 +0000 2018,@DMC_Ryan Definitely. We gave up some grip &amp; width in exchange for range. Would recommend stickier tires &amp; wider on… https://t.co/2I9NwrpQXA,1207,84,1291,2018-07-20
666,1020067893222858752,Thu Jul 19 22:08:32 +0000 2018,"Thanks Dan, you are a tough reviewer, so this means a lot coming from you. Please lmk even smallest nuance that can… https://t.co/COHuQVgtco",14723,1010,15733,2018-07-19
667,1020067153133764608,Thu Jul 19 22:05:35 +0000 2018,"RT @WSJ: The Tesla brand has its share of haters, but none have driven the new Model 3 Performance—until now. @DanNeilWSJ calls the car ""ma…",0,968,968,2018-07-19
668,1019850418644381698,Thu Jul 19 07:44:22 +0000 2018,RT @Hyperloop: Student teams are arriving at @SpaceX for the 2018 Hyperloop Pod Competition! Testing is underway ahead of competition day t…,0,949,949,2018-07-19
669,1019684287266689024,Wed Jul 18 20:44:13 +0000 2018,"@MarkeR2002 @kevinbusch @Paracidic @otgray310 Wow, someone has really thought about this!",2645,77,2722,2018-07-18
670,1019667206034972672,Wed Jul 18 19:36:21 +0000 2018,I wish https://t.co/e31gxW4ZRY,21497,1834,23331,2018-07-18
671,1019472152796381185,Wed Jul 18 06:41:16 +0000 2018,"@adamchavez Nonetheless, his actions against me do not justify my actions against him, and for that I apologize to… https://t.co/42DGaBZtYH",8698,1031,9729,2018-07-18
672,1019471467304513537,Wed Jul 18 06:38:33 +0000 2018,"@adamchavez As this well-written article suggests, my words were spoken in anger after Mr. Unsworth said several un… https://t.co/dQyW0yV26v",22059,1933,23992,2018-07-18
673,1019453860086050816,Wed Jul 18 05:28:35 +0000 2018,"RT @martinengwicht: @JaneidyEve @KarenMun0z @RenataKonkoly @elonmusk And mostly nobody mentioned the letter Elon got from Richard ""Rick"" St…",0,777,777,2018-07-18
674,1019453757656928258,Wed Jul 18 05:28:11 +0000 2018,"RT @adamchavez: Finally a thorough piece of reporting on the @elonmusk Thai submarine fiasco. By a non-reporter. 

Journalism is dead. But…",0,6449,6449,2018-07-18
675,1019368951782957056,Tue Jul 17 23:51:11 +0000 2018,@lrroberts87 Good point,1459,58,1517,2018-07-17
676,1019360072135204864,Tue Jul 17 23:15:54 +0000 2018,RT @Teslarati: SpaceX’s Mr Steven spotted in high-speed test at sea with upgraded net ahead of fairing catch debut https://t.co/ZEDevsF0o2,0,450,450,2018-07-17
677,1019347118920568832,Tue Jul 17 22:24:26 +0000 2018,"RT @TeslaNapaValley: Napa Valley Tesla Finnish Tesla Model S taxi driver crosses 400000 km, 93% of battery life remains… https://t.co/LYUUg…",0,680,680,2018-07-17
678,1019040462407995392,Tue Jul 17 02:05:53 +0000 2018,"RT @business: Tesla critic flips his view, finds the Model 3 has the potential to be profitable https://t.co/s173rgFqwy https://t.co/dmhsVC…",0,743,743,2018-07-17
679,1019033219017072640,Tue Jul 17 01:37:06 +0000 2018,RT @GerberKawasaki: Great news that Munro says the Tesla #Model3 has a 30% margin potential. Contradicting earlier reports. Which we have a…,0,512,512,2018-07-17
680,1019018737238794242,Tue Jul 17 00:39:34 +0000 2018,"RT @cleantechnica: Sorry, Elon — Tesla Model 3 Much Better Than I Expected (#CleanTechnica Review) https://t.co/eaNZkWAEoR @elonmusk @tesla…",0,697,697,2018-07-17
681,1018505842281156608,Sun Jul 15 14:41:30 +0000 2018,@nealboudette @BertelSchmitt @AmazingChevVolt I have never donated to a SuperPAC,1778,87,1865,2018-07-15
682,1018333202140680192,Sun Jul 15 03:15:29 +0000 2018,"@danielbrennan Yes, about 0.5% of what I donated to @SierraClub, which is a reasonable amount to maintain an open dialogue",4395,280,4675,2018-07-15
683,1018330925384458240,Sun Jul 15 03:06:26 +0000 2018,Reports that I am a top donor to GOP are categorically false. I am not a top donor to any political party.,71817,6936,78753,2018-07-15
684,1018321524728610817,Sun Jul 15 02:29:05 +0000 2018,Thank you for fighting climate change. This affects every living creature on Earth. https://t.co/mm0cpaQLsn,33432,2985,36417,2018-07-15
685,1018291417012027392,Sun Jul 15 00:29:27 +0000 2018,"RT @elonmusk: @jack_p That said, I do not actually see the checks (changed that policy today). A nominal annual amount goes out automatical…",0,844,844,2018-07-15
686,1018290544986845184,Sun Jul 15 00:25:59 +0000 2018,"@jack_p That said, I do not actually see the checks (changed that policy today). A nominal annual amount goes out a… https://t.co/58UNLQ2HRC",9425,844,10269,2018-07-15
687,1018275019925753856,Sat Jul 14 23:24:18 +0000 2018,"RT @elonmusk: @jack_p Thanks Jack. To be clear, I am not a conservative. Am registered independent &amp; politically moderate. Doesn’t mean I’m…",0,4173,4173,2018-07-14
688,1018268378962640896,Sat Jul 14 22:57:54 +0000 2018,@stfuszn @jack_p So that they are willing to listen when I call to object about issues that negatively affect humanity,2746,161,2907,2018-07-14
689,1018265614295523328,Sat Jul 14 22:46:55 +0000 2018,"@jack_p Thanks Jack. To be clear, I am not a conservative. Am registered independent &amp; politically moderate. Doesn’… https://t.co/gLNQ9jRgLv",48268,4173,52441,2018-07-14
690,1018217539535433728,Sat Jul 14 19:35:53 +0000 2018,@AtomicDeke @aarong @AjaniTPV Actually true,545,10,555,2018-07-14
691,1017965998392184832,Sat Jul 14 02:56:21 +0000 2018,@premkrmufc @iPugsieHD Hold up a mirror &amp; see if it fogs,713,23,736,2018-07-14
692,1017963227261624321,Sat Jul 14 02:45:20 +0000 2018,"@johndstoll @WSJ @mtbarra I’m honored to work with an amazing group of people at Tesla, but always happy to talk to… https://t.co/UtqLJaHKb3",4041,161,4202,2018-07-14
693,1017961142113767425,Sat Jul 14 02:37:03 +0000 2018,@mrkylefield @neuroecology @thegrugq Safe to lick. I checked.,1213,51,1264,2018-07-14
694,1017949588295159808,Sat Jul 14 01:51:09 +0000 2018,@NASASpaceflight In a month or so,2122,100,2222,2018-07-14
695,1017949146366476289,Sat Jul 14 01:49:23 +0000 2018,"@iPugsieHD Will check with our cat, Schrödinger, but I don’t think she’s going to like it",1721,60,1781,2018-07-14
696,1017947370645057536,Sat Jul 14 01:42:20 +0000 2018,@iPugsieHD Spoiler alert. Next thing you’ll tell me is they don’t like pajamas.,1506,35,1541,2018-07-14
697,1017946621949173760,Sat Jul 14 01:39:21 +0000 2018,Feels like a show &amp; tell weekend. I wonder what the cat dragged in …,24718,1206,25924,2018-07-14
698,1017943438447259649,Sat Jul 14 01:26:42 +0000 2018,@neuroecology @thegrugq Don’t be too quick to lick. That could go wrong. Look closely &amp; smell first. Ur welcome.,5127,435,5562,2018-07-14
699,1017932094373355520,Sat Jul 14 00:41:38 +0000 2018,@aarong @AjaniTPV Lvl 16 Neutral Good Half-Elf Fighter/Magic-user,754,59,813,2018-07-14
700,1017930851257147398,Sat Jul 14 00:36:41 +0000 2018,@RenataKonkoly Yes,405,13,418,2018-07-14
701,1017930024668880897,Sat Jul 14 00:33:24 +0000 2018,@LanceUlanoff Wizard alien 🧙‍♂️👽,1277,68,1345,2018-07-14
702,1017913408526671872,Fri Jul 13 23:27:23 +0000 2018,"@AjaniTPV Yeah, but I got 100 gp &amp; Roc Feather of Never-ending Tickles",613,21,634,2018-07-13
703,1017911319884959744,Fri Jul 13 23:19:05 +0000 2018,"Wrote in Grimoire, joined Fellowship https://t.co/CFYBo3ZofE",13912,778,14690,2018-07-13
704,1017703538414227458,Fri Jul 13 09:33:26 +0000 2018,"Interesting read
https://t.co/6vvIEtYPiY",8945,1294,10239,2018-07-13
705,1017700488958144512,Fri Jul 13 09:21:19 +0000 2018,"@Tesla Whether you plan to buy a Dual Motor Performance Model 3 or not, take it for a test drive anyway. It’s like… https://t.co/WF5ZRE854J",14514,841,15355,2018-07-13
706,1017687152128380929,Fri Jul 13 08:28:19 +0000 2018,@Tesla @92107Runner Performance version suspension is 1cm lower &amp; has stronger brakes in upgrade package,2935,152,3087,2018-07-13
707,1017669545828511744,Fri Jul 13 07:18:21 +0000 2018,"@Malala @MalalaFund Happy birthday, Malala! Happy to support.",2256,138,2394,2018-07-13
708,1017564651096363008,Fri Jul 13 00:21:32 +0000 2018,"RT @Tesla: Model 3 Design Studio now open to North America
https://t.co/ArJZhwPf2y",0,2061,2061,2018-07-13
709,1017555410205671424,Thu Jul 12 23:44:49 +0000 2018,"@designheretic @LittleMissFlint Gathering input this week, will begin taking action next week and let people know how they can help",1312,70,1382,2018-07-12
710,1017554139486806016,Thu Jul 12 23:39:46 +0000 2018,@M3CHWARRI0R935 @itsMikeSki @deadpoolmovie Even have the URL https://t.co/bOUOek5Cvy,645,23,668,2018-07-12
711,1017553854932582400,Thu Jul 12 23:38:38 +0000 2018,"@WintersPB @itsMikeSki Hmm, could def make some pretty sweet high-tech micro-missiles in arrow form",733,22,755,2018-07-12
712,1017551759017988098,Thu Jul 12 23:30:19 +0000 2018,"@itsMikeSki If you have cool arrows, you’re in",17349,757,18106,2018-07-12
713,1017551484555276291,Thu Jul 12 23:29:13 +0000 2018,RT @LittleMissFlint: Hey world. Let’s set the record straight. My team has been working with @elonmusk and his team for over a week to figu…,0,4139,4139,2018-07-12
714,1017526866507452416,Thu Jul 12 21:51:24 +0000 2018,"@ToddKorpi @StarFire2258 Ok, thanks. Will let you know.",531,11,542,2018-07-12
715,1017380674850844678,Thu Jul 12 12:10:29 +0000 2018,"@karenaboutflint @DylanSheaMusic Sure, will call tomorrow",2279,196,2475,2018-07-12
716,1017373873510248448,Thu Jul 12 11:43:27 +0000 2018,"@isco__ They should go where their heart takes them, but some of the boys seem to be interested in physics &amp; engineering",1897,87,1984,2018-07-12
717,1017364353635508224,Thu Jul 12 11:05:38 +0000 2018,"With my team after a profoundly interesting discussion of history, philosophy &amp; luck with Vice President Wang in 中南… https://t.co/RswTpzEOQL",25522,1646,27168,2018-07-12
718,1017353611272163329,Thu Jul 12 10:22:57 +0000 2018,Excellent meetings with senior leaders in China. Very thoughtful about the long-term future.,13443,571,14014,2018-07-12
719,1017335221493075974,Thu Jul 12 09:09:52 +0000 2018,@hohocho Would love to. It’s been too long.,946,18,964,2018-07-12
720,1017335087334031360,Thu Jul 12 09:09:20 +0000 2018,@aparanjape Prob early next year,2286,165,2451,2018-07-12
721,1017333757077008385,Thu Jul 12 09:04:03 +0000 2018,Just finished an amazing 3 day visit to China. The world has never seen human energy &amp; vigor at such scale. Incredi… https://t.co/pdoSWxgzLa,42800,2931,45731,2018-07-12
722,1017329956173635584,Thu Jul 12 08:48:57 +0000 2018,@thanr Sure 🌌 💫,1151,12,1163,2018-07-12
723,1017328784834523136,Thu Jul 12 08:44:18 +0000 2018,"@Mickyni111 Look, at least it’s not the Magellanic Clouds. They’re basically next door.",714,19,733,2018-07-12
724,1017328199825575936,Thu Jul 12 08:41:58 +0000 2018,"Just between us, I have a teleportation stargate to the Andromeda galaxy. It’s amazing. https://t.co/eLqr4pLeIX",34126,3898,38024,2018-07-12
725,1017327005057146880,Thu Jul 12 08:37:13 +0000 2018,So true https://t.co/DLagzIxyHm,7286,493,7779,2018-07-12
726,1017305639591333888,Thu Jul 12 07:12:19 +0000 2018,@Vivek_17m @thanr The pumps I saw were running v high flow rate all the way from cave 3. They stopped shortly after… https://t.co/xwkAQtBZo1,1722,96,1818,2018-07-12
727,1017253864473530368,Thu Jul 12 03:46:35 +0000 2018,@thanr Sounds good,792,45,837,2018-07-12
728,1017253021405892608,Thu Jul 12 03:43:14 +0000 2018,@thanr Glad to hear that. Engineering team also getting feedback from the British dive team on how to improve the d… https://t.co/2lMW3CGKHW,13130,890,14020,2018-07-12
729,1017176625861963776,Wed Jul 11 22:39:40 +0000 2018,@vissmeerr @ArsenalDem @pvols1979 @CNET It will happen for sure. Damn.,676,25,701,2018-07-11
730,1017171482210811904,Wed Jul 11 22:19:14 +0000 2018,@greymusic Should drive temp to target. Why fan speed on app?,426,12,438,2018-07-11
731,1017170755421794304,Wed Jul 11 22:16:20 +0000 2018,@ArsenalDem @pvols1979 @CNET Lots of fake accounts on Twitter characterized by high following/follower ratio to mak… https://t.co/x6TzC5pd49,742,37,779,2018-07-11
732,1017165087423934465,Wed Jul 11 21:53:49 +0000 2018,"@tammyharrington @d20_highroller Damn, now I want donuts 🍩",666,37,703,2018-07-11
733,1017163248808833025,Wed Jul 11 21:46:31 +0000 2018,@d20_highroller Yeah,558,23,581,2018-07-11
734,1017161917616361472,Wed Jul 11 21:41:13 +0000 2018,@shplatt @StarFire2258 Good point. Maybe use non-plumbers with work inspected/approved by pros.,849,23,872,2018-07-11
735,1017157155638525952,Wed Jul 11 21:22:18 +0000 2018,"@StarFire2258 You’re right on both counts. Most houses in Flint have safe water, but they’ve lost faith in govt tes… https://t.co/6AhSuLOGiq",2404,322,2726,2018-07-11
736,1017155699216822272,Wed Jul 11 21:16:31 +0000 2018,@jonodiener Maybe rewarding to organize a barnstorming weekend for water filter installation?,646,42,688,2018-07-11
737,1017154709642072064,Wed Jul 11 21:12:35 +0000 2018,"@jonodiener For now, reply to my tweet with ppm &amp; ppb test results &amp; will send someone to install a water filter. C… https://t.co/jQKiSM3W6b",11686,1550,13236,2018-07-11
738,1017149641991680002,Wed Jul 11 20:52:27 +0000 2018,@DylanSheaMusic Please consider this a commitment that I will fund fixing the water in any house in Flint that has… https://t.co/UT3wmEE0m8,109695,27987,137682,2018-07-11
739,1017148623425921024,Wed Jul 11 20:48:24 +0000 2018,@jack Great move,2655,105,2760,2018-07-11
740,1017147323791446016,Wed Jul 11 20:43:14 +0000 2018,@vanschneider Why sir … 😊,643,18,661,2018-07-11
741,1017055691230466048,Wed Jul 11 14:39:07 +0000 2018,Stockholm: it’s not just a syndrome,46239,4071,50310,2018-07-11
742,1017054898171473920,Wed Jul 11 14:35:58 +0000 2018,@KirklandJones Good point,892,24,916,2018-07-11
743,1017054281638113280,Wed Jul 11 14:33:31 +0000 2018,"@annerajb Definitely. Can’t wait to try that. Been a little distracted past few months on mostly Tesla matters, but back at it soon.",735,33,768,2018-07-11
744,1017053826640048128,Wed Jul 11 14:31:42 +0000 2018,"@ZainRaz4 Yes, and springy, like a highly damped trampoline",594,30,624,2018-07-11
745,1017053585157193728,Wed Jul 11 14:30:45 +0000 2018,Well … it looked smaller on paper,13624,537,14161,2018-07-11
746,1017053297142784002,Wed Jul 11 14:29:36 +0000 2018,"Catching rocket fairings falling from space has proven tricky, so we made the net really big https://t.co/WMeNZeksRq",15813,1264,17077,2018-07-11
747,1017043569847091202,Wed Jul 11 13:50:57 +0000 2018,"RT @Toblerhaus: Solar roof is performing well through a week of July heat. Combo of using a/c and charging 2 EVs means we’re using a lot, b…",0,1330,1330,2018-07-11
748,1016967753771577344,Wed Jul 11 08:49:41 +0000 2018,@Katheri93719178 @dtemkin Yes. Caves are now filled with water again. Difficulty of passage is massively dependent… https://t.co/4HC5SrnzNs,1866,103,1969,2018-07-11
749,1016964791347187712,Wed Jul 11 08:37:55 +0000 2018,@JohnnaSabri @dtemkin It sometimes feels like reality is a moral filter. I suppose that is what religion tells us.… https://t.co/TfDhl2mtLQ,2739,200,2939,2018-07-11
750,1016962110687854593,Wed Jul 11 08:27:16 +0000 2018,@RockyPruitt @kulpability @DonAndrewBailey @haydentiff @TheFerris_Wheel @100K_Ideas @GotchuW Makes a lot of sense,466,11,477,2018-07-11
751,1016960469737693184,Wed Jul 11 08:20:44 +0000 2018,@dtemkin This reaction has shaken my opinion of many people. We were asked to create a backup option &amp; worked hard… https://t.co/smOo5175h3,61262,5270,66532,2018-07-11
752,1016944210753347585,Wed Jul 11 07:16:08 +0000 2018,@hankgreen @goodedesign I think the person who attacked me on Twitter will survive somehow,6213,241,6454,2018-07-11
753,1016936881823633408,Wed Jul 11 06:47:01 +0000 2018,@hankgreen @eehouls Thanks for correcting me. I meant to say over half a million people.,1874,48,1922,2018-07-11
754,1016934663154266112,Wed Jul 11 06:38:12 +0000 2018,RT @Teslarati: Elon Musk in Shanghai signs prelim agreement for Tesla factory in China with 500k vehicle capacity https://t.co/2NV7EaDOSK,0,1379,1379,2018-07-11
755,1016820172685012992,Tue Jul 10 23:03:15 +0000 2018,@DonAndrewBailey @haydentiff @TheFerris_Wheel @100K_Ideas @GotchuW Please lmk contamination levels of any kind when you test the water,815,33,848,2018-07-10
756,1016810899179474944,Tue Jul 10 22:26:24 +0000 2018,@DonAndrewBailey @TheFerris_Wheel @100K_Ideas @GotchuW Please lmk results of your water tests,825,26,851,2018-07-10
757,1016809376823246848,Tue Jul 10 22:20:21 +0000 2018,"@DonAndrewBailey @TheFerris_Wheel @100K_Ideas @GotchuW When you’re there next week, are you planning to test water sources for lead?",3419,111,3530,2018-07-10
758,1016734966812758017,Tue Jul 10 17:24:40 +0000 2018,@DMC_Ryan Should be very soon. We’ve already made around 100 Model 3 Performance cars for test drives in stores.,1028,72,1100,2018-07-10
759,1016733555278348288,Tue Jul 10 17:19:04 +0000 2018,@bevvscott @eehouls Exactly,6965,96,7061,2018-07-10
760,1016731812159254529,Tue Jul 10 17:12:08 +0000 2018,"@eehouls No, it means I created jobs for 50,000 people directly and, through parts suppliers &amp; supporting professio… https://t.co/FiVvSb64F6",114044,20444,134488,2018-07-10
761,1016696081697009664,Tue Jul 10 14:50:09 +0000 2018,@HelloCullen Already have,13460,605,14065,2018-07-10
762,1016695490438619136,Tue Jul 10 14:47:48 +0000 2018,"@blake_kistler @BBCWorld Ironically, the “billionaire” label, when used by media, is almost always meant to devalue… https://t.co/hpN4KtS30G",11656,1168,12824,2018-07-10
763,1016690602124046336,Tue Jul 10 14:28:23 +0000 2018,"@LanceUlanoff @BBCWorld Good for rescuing vulnerable patients in dangerous environments, particularly if water, tox… https://t.co/QBf1LM0CCa",3219,303,3522,2018-07-10
764,1016687688848510976,Tue Jul 10 14:16:48 +0000 2018,"@Sarthk007 @BBCWorld Yes, it was specifically designed to pass that point",1177,83,1260,2018-07-10
765,1016686032907931656,Tue Jul 10 14:10:14 +0000 2018,"@BBCWorld Moreover, based on extensive cave video review &amp; discussion with several divers who know journey, SpaceX… https://t.co/Je338lRp2R",4451,556,5007,2018-07-10
766,1016684366083190785,Tue Jul 10 14:03:36 +0000 2018,@BBCWorld The former Thai provincial governor (described inaccurately as “rescue chief”) is not the subject matter… https://t.co/XCnsVqZXTI,32445,4604,37049,2018-07-10
767,1016661708126015489,Tue Jul 10 12:33:34 +0000 2018,Great news that they made it out safely. Congratulations to an outstanding rescue team!,101564,21865,123429,2018-07-10
768,1016590017052004352,Tue Jul 10 07:48:42 +0000 2018,@teslamodel3fan @Tesla Ok,4078,143,4221,2018-07-10
769,1016443130017505280,Mon Jul 09 22:05:01 +0000 2018,Just returned from Cave 3. Mini-sub is ready if needed. It is made of rocket parts &amp; named Wild Boar after kids’ so… https://t.co/mB9p1ZaM9C,303854,84207,388061,2018-07-09
770,1016404574813478913,Mon Jul 09 19:31:49 +0000 2018,@Noizey_Man @JaneidyEve That would be cool. I wonder what it’s like under all that ice.,1223,52,1275,2018-07-09
771,1016128459054157825,Mon Jul 09 01:14:38 +0000 2018,@EnochKo @Anna_online A second one that is 30cm shorter is almost complete,3663,264,3927,2018-07-09
772,1016121109127876610,Mon Jul 09 00:45:25 +0000 2018,@JaneidyEve Yes. Those videos are from this morning.,989,51,1040,2018-07-09
773,1016119687191638016,Mon Jul 09 00:39:46 +0000 2018,"@Anna_online According to divers who have made the passage, yes. However, we also made an exact replica that is inf… https://t.co/cXuH8KawB6",5183,451,5634,2018-07-09
774,1016110809662066688,Mon Jul 09 00:04:30 +0000 2018,Simulating maneuvering through a narrow passage https://t.co/2z01Ut3vxJ,94989,23894,118883,2018-07-09
775,1016098616300187648,Sun Jul 08 23:16:02 +0000 2018,"@2morrowknight Thanks, but we’ve not done anything useful yet. It is all other people.",10153,532,10685,2018-07-08
776,1016097753963941890,Sun Jul 08 23:12:37 +0000 2018,"@bweikle According to divers who have made the journey, this is capable of maneuvering through all passages",4263,267,4530,2018-07-08
777,1016094166797996032,Sun Jul 08 22:58:22 +0000 2018,@binarybits @JaneidyEve Tube diameter is 31cm,4230,280,4510,2018-07-08
778,1016076907421417472,Sun Jul 08 21:49:47 +0000 2018,"@JaneidyEve Mini-sub arriving in about 17 hours. Hopefully useful. If not, perhaps it will be in a future situation.",12709,1664,14373,2018-07-08
779,1016074447122337792,Sun Jul 08 21:40:00 +0000 2018,Thanks @palicharterhigh for letting us use your pool,18558,789,19347,2018-07-08
780,1016070898590232577,Sun Jul 08 21:25:54 +0000 2018,@imscoops It is an honor to work with them,10993,332,11325,2018-07-08
781,1016064322357719040,Sun Jul 08 20:59:46 +0000 2018,"With some mods, this could also work as an escape pod in space",45940,3226,49166,2018-07-08
782,1016063173139427329,Sun Jul 08 20:55:12 +0000 2018,https://t.co/D1umiFDr1t,205376,53886,259262,2018-07-08
783,1016032769082716161,Sun Jul 08 18:54:23 +0000 2018,@IAmJohnMcMahon I want to know who is running the Etherium scambots! Mad skillz …,5846,531,6377,2018-07-08
784,1016032133314310144,Sun Jul 08 18:51:52 +0000 2018,@DocJohnG @PewellaClarke @dcliem It is both alarming &amp; explanatory that you run a psych ward,2336,119,2455,2018-07-08
785,1016031254465015808,Sun Jul 08 18:48:22 +0000 2018,"@KyleBrubaker Diver weight belts wrapped around outside. Mini-sub only weighs ~40kg dry, so easy to carry on long d… https://t.co/xrGhIiXJMB",1913,157,2070,2018-07-08
786,1016029337450004480,Sun Jul 08 18:40:45 +0000 2018,"@PPathole @JimmyVosika @dcliem Yeah, that sounds cool. Music makes things better. Calms the mind. Adding padded wal… https://t.co/pfHqkT6rS0",5735,410,6145,2018-07-08
787,1016026055272906752,Sun Jul 08 18:27:43 +0000 2018,"@astrography__ @dcliem Aluminum shell has high thermal conductivity, so will be close to ambient. If ambient is col… https://t.co/XlqEDQ7Z7A",3482,338,3820,2018-07-08
788,1016024280566394880,Sun Jul 08 18:20:39 +0000 2018,@dcliem  https://t.co/jL2sPT0NCp,6852,828,7680,2018-07-08
789,1016023545703383040,Sun Jul 08 18:17:44 +0000 2018,@dcliem Buoyancy adjusted by strapping diver weight belts around body of capsule. They’re prevented from sliding of… https://t.co/EiJtMrRi2u,987,97,1084,2018-07-08
790,1016022770365288449,Sun Jul 08 18:14:39 +0000 2018,"@MontanaSeptic @dcliem Testing for 3 more hours in LA, then it’s on a plane to Thailand",1998,364,2362,2018-07-08
791,1016022074307907584,Sun Jul 08 18:11:53 +0000 2018,"@dcliem Design based on dive team feedback (primarily Stanton): 4 air / oxygen ports front &amp; rear, front ports prot… https://t.co/wh1FrFPLdw",1573,214,1787,2018-07-08
792,1016014090320338944,Sun Jul 08 17:40:10 +0000 2018,@vcastillo630 @adblanche I am an engineer,1408,133,1541,2018-07-08
793,1016012966557188097,Sun Jul 08 17:35:42 +0000 2018,@annerajb @kulpability @sivarajkumar237 @KO_Sulli @Grady_Booch @slashdot Tight control code is always C,546,32,578,2018-07-08
794,1016006658881871876,Sun Jul 08 17:10:38 +0000 2018,@annerajb @sivarajkumar237 @KO_Sulli @Grady_Booch @slashdot Python is done right. Great name story too.,790,70,860,2018-07-08
795,1016005381686943744,Sun Jul 08 17:05:34 +0000 2018,"@DocJohnG @dcliem If I am a narcissist (which might be true), at least I am a useful one",16072,2989,19061,2018-07-08
796,1016002749446516737,Sun Jul 08 16:55:06 +0000 2018,@sivarajkumar237 @KO_Sulli @Grady_Booch @slashdot 🖤🖤🖤 Python 🖤🖤🖤,1251,252,1503,2018-07-08
797,1016000593616236545,Sun Jul 08 16:46:32 +0000 2018,@dcliem Pretty close. There is a nosecone on the front to protect against rocks impacting fwd air hoses with a hole… https://t.co/z4bYHLa76S,8399,661,9060,2018-07-08
798,1015999090050514944,Sun Jul 08 16:40:34 +0000 2018,@KO_Sulli @Grady_Booch @slashdot Turbo,454,14,468,2018-07-08
799,1015998786642907136,Sun Jul 08 16:39:21 +0000 2018,@Grady_Booch @slashdot C,480,21,501,2018-07-08
800,1015854883990265856,Sun Jul 08 07:07:32 +0000 2018,"@ayshardzn Given Chiang Rai airport hours, soonest we could’ve departed US was an hour ago, but cave now closed for… https://t.co/8RoMvBWoNP",1663,295,1958,2018-07-08
801,1015850486543495168,Sun Jul 08 06:50:04 +0000 2018,"@DowdEdward Will do. Even if not useful here, perhaps it will be in a future situation.",3659,592,4251,2018-07-08
802,1015835053807394816,Sun Jul 08 05:48:44 +0000 2018,Extremely talented dive team. Makes sense given monsoon. Godspeed. https://t.co/t5XRo3gTxK,51723,7299,59022,2018-07-08
803,1015761785272463360,Sun Jul 08 00:57:36 +0000 2018,@slashdot Yes,20880,2016,22896,2018-07-08
804,1015706931753652224,Sat Jul 07 21:19:38 +0000 2018,@dirkbonhomme @JelteDesign @maysacha Yes,2226,115,2341,2018-07-07
805,1015689632355250176,Sat Jul 07 20:10:53 +0000 2018,@JelteDesign @maysacha Fitted for a kid or small adult to minimize open air. Segmented compartments to place rocks… https://t.co/a3mBVmJ3Ga,1506,139,1645,2018-07-07
806,1015686382646259715,Sat Jul 07 19:57:58 +0000 2018,@abroadwithalec @maysacha Yes,1191,48,1239,2018-07-07
807,1015685823906234368,Sat Jul 07 19:55:45 +0000 2018,"@maysacha 4 handles/hitch points on front &amp; 4 on rear. 2 air tank connections on front &amp; 2 on rear, allowing 1 to 4… https://t.co/iRgempLWMJ",1955,212,2167,2018-07-07
808,1015676772338159618,Sat Jul 07 19:19:47 +0000 2018,@thanr @ablack82 I’m in LA working with the SpaceX team building the kid mini-sub,2806,566,3372,2018-07-07
809,1015666557458964480,Sat Jul 07 18:39:12 +0000 2018,"@aiyanaskye Construction complete in about 8 hours, then 17 hour flight to Thailand",3827,842,4669,2018-07-07
810,1015665633504063488,Sat Jul 07 18:35:31 +0000 2018,"Continue to be amazed by the bravery, resilience &amp; tenacity of kids &amp; diving team in Thailand. Human character at its best.",84030,11756,95786,2018-07-07
811,1015657378140704768,Sat Jul 07 18:02:43 +0000 2018,"Got more great feedback from Thailand. Primary path is basically a tiny, kid-size submarine using the liquid oxygen… https://t.co/612iFUn4Zi",77817,13022,90839,2018-07-07
812,1015654917782978560,Sat Jul 07 17:52:57 +0000 2018,@VoltzCoreAudio Ground winds would,584,10,594,2018-07-07
813,1015648140341403648,Sat Jul 07 17:26:01 +0000 2018,@VoltzCoreAudio Yes. All-weather. ~300km/h high altitude winds. ~60km/h ground winds. It’s a beast.,5184,251,5435,2018-07-07
814,1015529153817239552,Sat Jul 07 09:33:12 +0000 2018,@jevjack1 Can’t be too buoyant,558,24,582,2018-07-07
815,1015507453818044416,Sat Jul 07 08:06:58 +0000 2018,Some good feedback from cave experts in Thailand. Iterating with them on an escape pod design that might be safe en… https://t.co/5yqKGma8tL,151420,23845,175265,2018-07-07
816,1015401128744194048,Sat Jul 07 01:04:28 +0000 2018,"RT @SpaceX: Filled with more than 5,900 pounds of @NASA cargo and research materials, Dragon was captured by @Space_Station crew members an…",0,5336,5336,2018-07-07
817,1015366461957627904,Fri Jul 06 22:46:43 +0000 2018,@ArkadiuszKula @JL2579 @MattyIce4412 @thanr @JamesWorldSpace Good idea,897,31,928,2018-07-06
818,1015363973611425793,Fri Jul 06 22:36:50 +0000 2018,@JL2579 @MattyIce4412 @thanr @JamesWorldSpace Prob wise to add an air tank (butt end fwd to take impacts) in nose o… https://t.co/b1goueIgk9,1152,94,1246,2018-07-06
819,1015361792007069696,Fri Jul 06 22:28:10 +0000 2018,@LittleMissFlint You’re welcome. Happy birthday! 🎁🎉🎂,3120,71,3191,2018-07-06
820,1015360604192768000,Fri Jul 06 22:23:27 +0000 2018,"@MattyIce4412 @thanr @JamesWorldSpace Yeah, that’s what I’m talking about in that tweet — double-layer Kevlar press… https://t.co/CiIRm3xdrv",1150,96,1246,2018-07-06
821,1015359443876360192,Fri Jul 06 22:18:50 +0000 2018,@williamwinters @austinhopperrrr @maysacha @thanr @JamesWorldSpace Exactly. You can put socks on your feet the same… https://t.co/oeUSNGfjMx,539,20,559,2018-07-06
822,1015355758471532549,Fri Jul 06 22:04:11 +0000 2018,@jeremysliew It’s open so that others who are closer to the problem can consider this as one possible solution,9607,533,10140,2018-07-06
823,1015350212808749056,Fri Jul 06 21:42:09 +0000 2018,"@siwgrindaker @erikveen Should be possible to increase the air inflow rate above the leak rate, unless there is a v… https://t.co/0Mr2TEYOwx",555,28,583,2018-07-06
824,1015342277017784320,Fri Jul 06 21:10:37 +0000 2018,@erikveen I would def recommend this,3695,101,3796,2018-07-06
825,1015341937115553793,Fri Jul 06 21:09:16 +0000 2018,@thanr @JamesWorldSpace Building double-layer Kevlar pressure pods with Teflon coating to slip by rocks &amp; front/rea… https://t.co/FWamFRnfcx,1375,156,1531,2018-07-06
826,1015334555002081280,Fri Jul 06 20:39:56 +0000 2018,@bonnienorman @TeslaBull @trippedover Interesting,592,20,612,2018-07-06
827,1015310752830218241,Fri Jul 06 19:05:21 +0000 2018,"@thanr @JamesWorldSpace Great, thanks",1185,55,1240,2018-07-06
828,1015307876829548544,Fri Jul 06 18:53:56 +0000 2018,@JamesWorldSpace Inflatable tubes &amp; pods being made out of Kevlar for better abrasion resistance. A SpaceX engineer… https://t.co/0VbCvcxPlp,2041,356,2397,2018-07-06
829,1015286165383987200,Fri Jul 06 17:27:39 +0000 2018,"@ladykayaker @JamesWorldSpace So long as air pressure in tube higher than water pressure, air will blow out &amp; water won’t come in",794,63,857,2018-07-06
830,1015276185293426688,Fri Jul 06 16:48:00 +0000 2018,@thanr @JamesWorldSpace Does you know output voltage &amp; amperage of those generator trucks? 3 phase? What frequency?… https://t.co/Oxw6dqOISy,1765,190,1955,2018-07-06
831,1015138953693880320,Fri Jul 06 07:42:41 +0000 2018,@JamesWorldSpace SpaceX &amp; Boring Co engineers headed to Thailand tomorrow to see if we can be helpful to govt. Ther… https://t.co/fEMwkYrXCj,21733,7914,29647,2018-07-06
832,1015137456901931008,Fri Jul 06 07:36:44 +0000 2018,@JamesWorldSpace Looks like 1st bit of water is close enough to entrance to be pumped out. 2nd &amp; 3rd would need bat… https://t.co/nzIsXGC1XH,3854,683,4537,2018-07-06
833,1015116567477014528,Fri Jul 06 06:13:44 +0000 2018,"@chiefpad @JamesWorldSpace So long as air feed rate exceeds leak rate, tube remains inflated. This is how bouncy ca… https://t.co/r61BkOjPMg",2103,240,2343,2018-07-06
834,1015115481097777152,Fri Jul 06 06:09:25 +0000 2018,@chiefpad @JamesWorldSpace Have a small velcro slit entrance &amp; exit in circumferential direction (half stress of longitudinal direction),1504,143,1647,2018-07-06
835,1015108458067124225,Fri Jul 06 05:41:30 +0000 2018,"@ladykayaker @JamesWorldSpace Walking speed is around 5km/h, but if you’re in an air tube, time doesn’t matter much… https://t.co/Yo66p5GoUx",2057,251,2308,2018-07-06
836,1015105570527821824,Fri Jul 06 05:30:02 +0000 2018,RT @elonmusk: @JamesWorldSpace Maybe worth trying: insert a 1m diameter nylon tube (or shorter set of tubes for most difficult sections) th…,0,4491,4491,2018-07-06
837,1015105500105412610,Fri Jul 06 05:29:45 +0000 2018,@JamesWorldSpace Maybe worth trying: insert a 1m diameter nylon tube (or shorter set of tubes for most difficult se… https://t.co/1ZXml7WYg5,21876,4491,26367,2018-07-06
838,1015004489567256576,Thu Jul 05 22:48:22 +0000 2018,@cate_long @lopezlinette Exactly. A journalist who publicly expresses love for &amp; parties in Vegas with a prominent… https://t.co/fUc45vYQ8f,1832,130,1962,2018-07-05
839,1015000443267645441,Thu Jul 05 22:32:18 +0000 2018,"@MelissaLeeCNBC @thesheetztweetz @CNBC @Lebeaucarnews I know you &amp; believe you, but it means Lopez misled readers i… https://t.co/JQBw5TZffj",630,25,655,2018-07-05
840,1014998760638697473,Thu Jul 05 22:25:36 +0000 2018,@jowens510 @lopezlinette I didn’t ask anyone and the people who sent the snapshots don’t work for me. They just don’t like hypocrites.,1977,52,2029,2018-07-05
841,1014987505978863616,Thu Jul 05 21:40:53 +0000 2018,@lopezlinette They were sent to me by multiple people on the Internet. I don’t use Facebook.,9525,342,9867,2018-07-05
842,1014987092697346048,Thu Jul 05 21:39:15 +0000 2018,@thesheetztweetz @CNBC @Lebeaucarnews Lopez wrote that Melissa Lee of CNBC was “dancing her face off” with Chanos i… https://t.co/3pHoYsgHUJ,740,38,778,2018-07-05
843,1014986117341253633,Thu Jul 05 21:35:22 +0000 2018,@S_Padival @lopezlinette Why did @lopezlinette publish a love letter puff piece about Chanos’s cuff links? Who took… https://t.co/Hh2fsRE0oU,514,44,558,2018-07-05
844,1014982701634351104,Thu Jul 05 21:21:48 +0000 2018,@S_Padival @lopezlinette  https://t.co/ystkbF7p1W,480,43,523,2018-07-05
845,1014982448826871808,Thu Jul 05 21:20:47 +0000 2018,@S_Padival @lopezlinette .@Lopezlinette posted on social media that she was partying in Vegas with Chanos &amp; Tepper… https://t.co/EGWFsvgHuV,627,42,669,2018-07-05
846,1014964962718973952,Thu Jul 05 20:11:18 +0000 2018,@Rayhawn @Tesla Norwegians are right to be upset with Tesla. We are having trouble expanding our service facilities… https://t.co/bJfS1tN3GQ,5989,278,6267,2018-07-05
847,1014964102672801792,Thu Jul 05 20:07:53 +0000 2018,@ajs @nichcarlson @businessinsider @lopezlinette Are you 100% certain that @businessinsider stands by @lopezlinette… https://t.co/ZIyPs27OfR,1697,109,1806,2018-07-05
848,1014952644555599872,Thu Jul 05 19:22:22 +0000 2018,@tombrechet @vassilyk @FlatJannrickles @vincent13031925 @TeslaBull @scottwww @stetopinini @S_Padival @lopezlinette… https://t.co/aCdLPVZpK1,470,13,483,2018-07-05
849,1014948255950442496,Thu Jul 05 19:04:55 +0000 2018,@steveshmidt @thesheetztweetz @CNBC @Lebeaucarnews True,689,14,703,2018-07-05
850,1014942490690969600,Thu Jul 05 18:42:01 +0000 2018,@vincent13031925 @TeslaBull @scottwww @stetopinini @S_Padival @lopezlinette So @lopezlinette publicly stated she st… https://t.co/iv5psmu8Hq,923,72,995,2018-07-05
851,1014935357345763330,Thu Jul 05 18:13:40 +0000 2018,@scottwww @stetopinini @S_Padival @lopezlinette .@lopezlinette You stated publicly that you “see eye to eye” with C… https://t.co/K9th8YxXhx,848,66,914,2018-07-05
852,1014932627986370560,Thu Jul 05 18:02:49 +0000 2018,@TeslaBull What a coincidence …,2963,120,3083,2018-07-05
853,1014932211584266240,Thu Jul 05 18:01:10 +0000 2018,@thesheetztweetz @CNBC @Lebeaucarnews Am not attacking all media or even all of @CNBC. Just asked if you inform pub… https://t.co/B6PC5Rixzv,2397,157,2554,2018-07-05
854,1014923546210938880,Thu Jul 05 17:26:44 +0000 2018,"@stetopinini @S_Padival @lopezlinette Indeed, very simple question. To be specific: @lopezlinette, did you compensa… https://t.co/L1YzSj4KIN",1078,96,1174,2018-07-05
855,1014919249620418562,Thu Jul 05 17:09:40 +0000 2018,"@benjaminpollock @CNBC Exactly. @cnbc, I just asked a simple question. Please answer.",679,37,716,2018-07-05
856,1014834534687404032,Thu Jul 05 11:33:02 +0000 2018,"@ICannot_Enough @SimRiyat @gawwy @aperezposada @Reuters @sal19 Strange. @cnbc, is it true that you are putting on a… https://t.co/gXgrH5MtQg",1190,139,1329,2018-07-05
857,1014832343322783744,Thu Jul 05 11:24:19 +0000 2018,RT @cleantechnica: Business Insider Resorts To FUD As Tesla Streamlines Model 3 General Assembly Lines — #Pravduh https://t.co/VgU9rCnewV h…,0,480,480,2018-07-05
858,1014832249705910272,Thu Jul 05 11:23:57 +0000 2018,RT @cleantechnica: A Sinister Cellar Of The TSLA Short Story? https://t.co/NYQ66lSqT2 https://t.co/877zL5zJuK,0,610,610,2018-07-05
859,1014812681499365376,Thu Jul 05 10:06:12 +0000 2018,"Note, no one is in the car or controlling remotely. Car is driving entirely by itself. https://t.co/xSG2Mmy756",24976,2535,27511,2018-07-05
860,1014812412367630337,Thu Jul 05 10:05:08 +0000 2018,RT @ElectrekCo: Tesla Powerwalls save the day during heat wave in Vermont https://t.co/x1xsHc7bZW,0,959,959,2018-07-05
861,1014811835017584640,Thu Jul 05 10:02:50 +0000 2018,"@S_Padival @lopezlinette Sounds very sketchy if true. @lopezlinette, is it possible you’re  serving as an inside tr… https://t.co/3P4Dz914pj",1394,178,1572,2018-07-05
862,1014806548340568065,Thu Jul 05 09:41:49 +0000 2018,"@S_Padival @lopezlinette has published several false articles about Tesla, including a doozy where she claimed Tesl… https://t.co/gCOQfa789D",3288,204,3492,2018-07-05
863,1014800936198213633,Thu Jul 05 09:19:31 +0000 2018,"@gawwy @aperezposada @Reuters @sal19 Wow, so @sal19 of @Reuters wrote article that misled public about Model 3 prod… https://t.co/zUnyVwK1dV",847,49,896,2018-07-05
864,1014785678263980032,Thu Jul 05 08:18:54 +0000 2018,"@aperezposada @Reuters .@Reuters, why did you mislead the people public about this number?",620,47,667,2018-07-05
865,1014785289967923200,Thu Jul 05 08:17:21 +0000 2018,@aperezposada @Reuters .@Reuters is relentlessly negative about Tesla. They just wrote a bogus article saying S pro… https://t.co/wLHhnb3mZp,1036,117,1153,2018-07-05
866,1014774891575300097,Thu Jul 05 07:36:02 +0000 2018,@LittleMissFlint Happy to support,950,43,993,2018-07-05
867,1014754638950645760,Thu Jul 05 06:15:33 +0000 2018,@MabzMagz Boring Co has advanced ground penetrating radar &amp; is pretty good at digging holes. Don’t know if pump rat… https://t.co/w4AVyLp3Ku,7070,1479,8549,2018-07-05
868,1014752999594323968,Thu Jul 05 06:09:02 +0000 2018,@AWatsonMenswear Belfast is beautiful,545,70,615,2018-07-05
869,1014752854333009921,Thu Jul 05 06:08:28 +0000 2018,"@BelTel No, was just there with my kids for a few hours to see the GoT set &amp; had dinner at a pub. Love the show and GRRM’s books.",10091,386,10477,2018-07-05
870,1014752450442457088,Thu Jul 05 06:06:52 +0000 2018,@davealexhou Should be coming soon,2218,33,2251,2018-07-05
871,1014739003281530880,Thu Jul 05 05:13:25 +0000 2018,@icp I will buy tons of your merch,843,92,935,2018-07-05
872,1014634671735562240,Wed Jul 04 22:18:51 +0000 2018,"@Cody_Walker9 Very early on, we had the ability to use the car as a battery outputting power. Maybe worth revisiting that.",632,29,661,2018-07-04
873,1014632045505630209,Wed Jul 04 22:08:25 +0000 2018,"@antonlodder Camera &amp; onboard neural net should detect. If very close (below 15 ft), will show up on ultrasonics",469,19,488,2018-07-04
874,1014631215587053573,Wed Jul 04 22:05:07 +0000 2018,"@LittleMissFlint Ok, will look into it",1537,103,1640,2018-07-04
875,1014509856777293825,Wed Jul 04 14:02:53 +0000 2018,"@MabzMagz I suspect that the Thai govt has this under control, but I’m happy to help if there is a way to do so",21177,3070,24247,2018-07-04
876,1014321463430668288,Wed Jul 04 01:34:16 +0000 2018,@starbirdsonmars @Grimezsz @loonatheworld You never know ..,1653,127,1780,2018-07-04
877,1014320250551226369,Wed Jul 04 01:29:27 +0000 2018,@Grimezsz @loonatheworld ⚡️Loona⚡️,5855,3119,8974,2018-07-04
878,1014318495964782592,Wed Jul 04 01:22:29 +0000 2018,@robertoblake @yanquetino @Tesla Ideas &amp; corrections that could make a product or service better are always welcome,945,42,987,2018-07-04
879,1014317550891601922,Wed Jul 04 01:18:43 +0000 2018,@nevona Yeah I like ICP,3805,1717,5522,2018-07-04
880,1014316162094698496,Wed Jul 04 01:13:12 +0000 2018,@yanquetino @Tesla Noted,6920,104,7024,2018-07-04
881,1014306145702432768,Wed Jul 04 00:33:24 +0000 2018,"@kimwim Wow, Model A. That’s cool.",809,13,822,2018-07-04
882,1014296276521836544,Tue Jul 03 23:54:11 +0000 2018,Whoop whoop https://t.co/Xq3JlcQizc,19586,3117,22703,2018-07-03
883,1014248438710636544,Tue Jul 03 20:44:06 +0000 2018,The Spice Flows https://t.co/YMyhVGIxHc,21921,1760,23681,2018-07-03
884,1013899626477473792,Mon Jul 02 21:38:02 +0000 2018,"@WillFealey @Tesla @RadioFlyer No problem, happy to donate some personally",1797,77,1874,2018-07-02
885,1013897145773166595,Mon Jul 02 21:28:11 +0000 2018,@WillFealey @Tesla @RadioFlyer Sure,8393,266,8659,2018-07-02
886,1013896484247490565,Mon Jul 02 21:25:33 +0000 2018,@bkbkbk @LibertyMutual Looking into this. Will fix if so.,515,10,525,2018-07-02
887,1013519243030253570,Sun Jul 01 20:26:32 +0000 2018,"7000 cars, 7 days
♥️ Tesla Team ♥️",150961,14124,165085,2018-07-01
888,1012942067365023744,Sat Jun 30 06:13:03 +0000 2018,@santidebus Then what’s this wand for?,1609,61,1670,2018-06-30
889,1012843449534435328,Fri Jun 29 23:41:10 +0000 2018,@keyonchrist 💡,843,38,881,2018-06-29
890,1012830881461907457,Fri Jun 29 22:51:14 +0000 2018,"Who likes short shorts?
https://t.co/hoKsDT8xdS",9006,657,9663,2018-06-29
891,1012784447005995008,Fri Jun 29 19:46:43 +0000 2018,Or at least the closest thing to magic that exists in the real world,42126,4042,46168,2018-06-29
892,1012783785736167424,Fri Jun 29 19:44:05 +0000 2018,Excession https://t.co/h4AYwxbS3h,7031,578,7609,2018-06-29
893,1012783222386712576,Fri Jun 29 19:41:51 +0000 2018,Engineering is magic,138387,32062,170449,2018-06-29
894,1012782315343306753,Fri Jun 29 19:38:15 +0000 2018,@SouthPark Love Awesomo,3032,155,3187,2018-06-29
895,1012781170633740289,Fri Jun 29 19:33:42 +0000 2018,@stui999  https://t.co/AZ4aidXs33,860,67,927,2018-06-29
896,1012777990193852417,Fri Jun 29 19:21:04 +0000 2018,Space Laser https://t.co/8CQ6L9si3f,6490,575,7065,2018-06-29
897,1012777784169488385,Fri Jun 29 19:20:14 +0000 2018,@Stun_Empire 🧛‍♀️,1480,195,1675,2018-06-29
898,1012777706554085376,Fri Jun 29 19:19:56 +0000 2018,Spacebow https://t.co/Ht4GCsaQo9,5447,546,5993,2018-06-29
899,1012644501129592833,Fri Jun 29 10:30:37 +0000 2018,RT @Bob_Richards: Wow. That was beautiful. Thanks @SpaceX @elonmusk https://t.co/vnWlwNMbxr,0,2693,2693,2018-06-29
900,1012644110719578112,Fri Jun 29 10:29:04 +0000 2018,RT @AntVenom: @SpaceX @elonmusk @Space_Station I’m glad I got the opportunity to see the Dragon’s Tail in person. 😁👍 https://t.co/nliDgNAaTS,0,676,676,2018-06-29
901,1012643485986385920,Fri Jun 29 10:26:35 +0000 2018,RT @SpaceX: Dragon is on its way to the International Space Station. Capture by @Space_Station crew set for Monday morning.,0,1153,1153,2018-06-29
902,1012604447552204805,Fri Jun 29 07:51:28 +0000 2018,"@JaneidyEve Everything is sentient, especially sentience",1707,66,1773,2018-06-29
903,1012603848647561217,Fri Jun 29 07:49:05 +0000 2018,"@himanshu_ragtah @Gizmodo If the rules force defeat, the rules must change",566,41,607,2018-06-29
904,1012603171774984192,Fri Jun 29 07:46:24 +0000 2018,The Spice. Must. Flow. https://t.co/ov4aLIwzKz,53564,4207,57771,2018-06-29
905,1012597509858869254,Fri Jun 29 07:23:54 +0000 2018,Open the Knaack HAL https://t.co/EG47rvPppF,6501,284,6785,2018-06-29
906,1012596720193044480,Fri Jun 29 07:20:45 +0000 2018,@JaneidyEve @WorldAndScience 🛸 obv,487,22,509,2018-06-29
907,1012590645452554240,Fri Jun 29 06:56:37 +0000 2018,@Techmeme @crystalttc … the money,825,33,858,2018-06-29
908,1012590428791627776,Fri Jun 29 06:55:45 +0000 2018,@Pamaj @KEEMSTAR Follow the 🐇,3479,204,3683,2018-06-29
909,1012590050196971520,Fri Jun 29 06:54:15 +0000 2018,@JohnnaSabri @JaneidyEve @WorldAndScience Busted. It’s me.,767,31,798,2018-06-29
910,1012588909266522113,Fri Jun 29 06:49:43 +0000 2018,@KEEMSTAR 👻,15564,644,16208,2018-06-29
911,1012588722313805824,Fri Jun 29 06:48:59 +0000 2018,@JaneidyEve @WorldAndScience That pretty much proves it isn’t me,616,17,633,2018-06-29
912,1012585297790394369,Fri Jun 29 06:35:22 +0000 2018,@WorldAndScience Certianly glad I’m not one them. Phew!,5961,235,6196,2018-06-29
913,1012539571127533568,Fri Jun 29 03:33:40 +0000 2018,RT @SpaceX: Falcon 9 and Dragon went vertical tonight ahead of tomorrow’s resupply mission to the @ISS. Weather is 90% favorable for launch…,0,1541,1541,2018-06-29
914,1012455844850487296,Thu Jun 28 22:00:58 +0000 2018,"@himanshu_ragtah @Gizmodo Wrath of Khan, Kobayashi Maru",480,21,501,2018-06-28
915,1012450863099535361,Thu Jun 28 21:41:10 +0000 2018,@Gizmodo Sad news. He wrote some epic sci fi.,2474,94,2568,2018-06-28
916,1012433056957751296,Thu Jun 28 20:30:25 +0000 2018,@westcoastbill Thanks Bill,1079,22,1101,2018-06-28
917,1012432838422159362,Thu Jun 28 20:29:33 +0000 2018,Paint shop https://t.co/G2rIe1qYG4,4933,254,5187,2018-06-28
918,1012421769607561216,Thu Jun 28 19:45:34 +0000 2018,@daveydo2000 @jules_su @EricIdle That’s cool. One of my favorite lines! Monty Python is so brilliant.,464,15,479,2018-06-28
919,1012418999596937216,Thu Jun 28 19:34:33 +0000 2018,"@KiannaFierce Oh, I love trap. Good suggestions welcome!",829,77,906,2018-06-28
920,1012418622021517312,Thu Jun 28 19:33:03 +0000 2018,@mathetes76 @jules_su We need more &amp; better emojis now!!Seriously. So little to work with.,546,23,569,2018-06-28
921,1012416878818410496,Thu Jun 28 19:26:08 +0000 2018,"@jules_su And one more thing, your father smells of 🍒 and I 💨 in your general direction",884,49,933,2018-06-28
922,1012416542724665346,Thu Jun 28 19:24:48 +0000 2018,"Appreciate all the good wishes. First bday I’ve spent in the factory, but it’s somehow the best.",61986,2933,64919,2018-06-28
923,1012415844238815232,Thu Jun 28 19:22:01 +0000 2018,"@jules_su We didn’t steal his mug crayon drawing of a farting unicorn,
We didn’t benefit from it,
We don’t want it,… https://t.co/EU9wkvd83w",987,58,1045,2018-06-28
924,1012166284224524288,Thu Jun 28 02:50:21 +0000 2018,"@Model3Owners @boringcompany Happily for the victorious 🐌, he is indeed still far faster than Godot. Line-Storm com… https://t.co/Nv4u27TPQq",2898,96,2994,2018-06-28
925,1011850474016788480,Wed Jun 27 05:55:26 +0000 2018,@coronadetucson Bronco rocks,1288,33,1321,2018-06-27
926,1011849186692616194,Wed Jun 27 05:50:20 +0000 2018,"@rajmathai @Tesla @Teslarati No standard automotive solution could be built in time, so we created a new solution.… https://t.co/2g58Ubosxx",5567,329,5896,2018-06-27
927,1011846284351717379,Wed Jun 27 05:38:48 +0000 2018,@pulletsforever All Tesla vehicles come with cabin overheat protection https://t.co/q9fjKckewO,2060,236,2296,2018-06-27
928,1011839580830482432,Wed Jun 27 05:12:09 +0000 2018,@clprenz @JoeyOstrander I hate whole idea of brands and branding. So much bs. I hope it messes with our brand. Brands suck.,3916,311,4227,2018-06-27
929,1011838788245454848,Wed Jun 27 05:09:00 +0000 2018,"@TheSeanBooker Sir, this will not be some a dainty little buttercup of a truck! Driver’s seat will be big enough to… https://t.co/cPUkvgThML",3376,120,3496,2018-06-27
930,1011835761182666752,Wed Jun 27 04:56:59 +0000 2018,"@JoeyOstrander 400 to 500 mile option definitely. Higher, maybe.",2463,57,2520,2018-06-27
931,1011835467342336002,Wed Jun 27 04:55:49 +0000 2018,@ZacksJerryRig For sure,1535,21,1556,2018-06-27
932,1011834343289806848,Wed Jun 27 04:51:21 +0000 2018,@MattPTurner Should be easy to add as a feature like calendar,978,16,994,2018-06-27
933,1011833857719451648,Wed Jun 27 04:49:25 +0000 2018,You’re welcome! https://t.co/NcsGhhB1Ja,11044,479,11523,2018-06-27
934,1011798626526351360,Wed Jun 27 02:29:25 +0000 2018,@TheHoff525 Yes. Highly recommend doing so btw.,1544,29,1573,2018-06-27
935,1011794673910759425,Wed Jun 27 02:13:43 +0000 2018,@clintdebusk That will be standard,2729,39,2768,2018-06-27
936,1011790990175162369,Wed Jun 27 01:59:04 +0000 2018,@cubamark That goes without saying https://t.co/h5WDKpfZi0,1794,102,1896,2018-06-27
937,1011788218734391296,Wed Jun 27 01:48:04 +0000 2018,"@phycho_hippie 300,000 lb towing capacity",774,61,835,2018-06-27
938,1011777209483186176,Wed Jun 27 01:04:19 +0000 2018,"RT @SpaceX: At Naval Air Facility El Centro in Southern California, SpaceX recently completed its 16th test of Crew Dragon’s parachute syst…",0,3690,3690,2018-06-27
939,1011776953051828226,Wed Jun 27 01:03:18 +0000 2018,"RT @elonmusk: @Penenberg For sure! When doing US govt crash safety testing, the Model S roof was so strong, it broke their testing machine.…",0,1722,1722,2018-06-27
940,1011776242016612352,Wed Jun 27 01:00:28 +0000 2018,@wbwhitehouse It will,1816,21,1837,2018-06-27
941,1011761562523086848,Wed Jun 27 00:02:08 +0000 2018,"@Penenberg For sure! When doing US govt crash safety testing, the Model S roof was so strong, it broke their testin… https://t.co/XyK9lpSHCf",12274,1722,13996,2018-06-27
942,1011760743929110528,Tue Jun 26 23:58:53 +0000 2018,"@MuellerJeffrey Wow, great idea! Since it will already have a Tesla pneumatics system, it totally makes sense to add a utility port.",1506,50,1556,2018-06-26
943,1011724688706318337,Tue Jun 26 21:35:37 +0000 2018,"Pickup truck will have power outlets allowing use of heavy duty 240V, high power tools in field all day. No generator needed.",32383,2554,34937,2018-06-26
944,1011678031801249793,Tue Jun 26 18:30:13 +0000 2018,The Tesla Truck will have dual motor all-wheel drive w crazy torque &amp; a suspension that dynamically adjusts for loa… https://t.co/Oa9chXHSp7,33308,2682,35990,2018-06-26
945,1011676624993972224,Tue Jun 26 18:24:38 +0000 2018,@aMidLifeCrisis It will parallel park automatically &amp; have 360 degree cameras &amp; sonar,5226,160,5386,2018-06-26
946,1011672532838055937,Tue Jun 26 18:08:22 +0000 2018,"What would you love to see in a Tesla pickup truck? I have a few things in mind, but what do you think are small, b… https://t.co/iTfGbHL4tf",54254,5142,59396,2018-06-26
947,1011669859577446401,Tue Jun 26 17:57:45 +0000 2018,@EV20018 @justwidle2 @Tesla “Virtue signaling” is super annoying &amp; there are lots of phoneys who are actually huge… https://t.co/LcmCtCk5R3,605,33,638,2018-06-26
948,1011666426715766784,Tue Jun 26 17:44:06 +0000 2018,@justwidle2 @Tesla Don’t buy our car if that’s a problem. People should be free to live their lives where their heart takes them ❤️🧡💛💚💙💜🖤💖🌈,2725,476,3201,2018-06-26
949,1011660804104470528,Tue Jun 26 17:21:46 +0000 2018,@justwidle2 @Tesla Then you will really hate that Tesla scored 100/100 four years in a row on LGBTQ equality https://t.co/AzwWIhpyLW,1234,88,1322,2018-06-26
950,1011484430030917632,Tue Jun 26 05:40:55 +0000 2018,RT @Tesla: Tesla team celebrates Pride Month 🏳️‍🌈 https://t.co/O3PTdWbPeg,0,2925,2925,2018-06-26
951,1011383865506652160,Mon Jun 25 23:01:18 +0000 2018,RT @Teslarati: Tesla Model 3 beats runner-up Porsche Boxster to win Time Attack race event - https://t.co/qcnwpfkaiQ https://t.co/gpLNU0a4uC,0,744,744,2018-06-25
952,1011150772803809280,Mon Jun 25 07:35:05 +0000 2018,@RationalEtienne @PPathole @RehearsalLot @guiscaesar @surfersnout @aedmondsauthor @barbiesway @TwitterMoments… https://t.co/fNxSuz7Bgr,894,96,990,2018-06-25
953,1011145255108820992,Mon Jun 25 07:13:09 +0000 2018,@PPathole @RehearsalLot @guiscaesar @surfersnout @aedmondsauthor @barbiesway @TwitterMoments @RepMaxineWaters… https://t.co/vr4p3MWWn0,505,37,542,2018-06-25
954,1011143866555088896,Mon Jun 25 07:07:38 +0000 2018,@coremwm Hopefully in V9.0 release in a few months,598,34,632,2018-06-25
955,1011142550701236226,Mon Jun 25 07:02:24 +0000 2018,@JohnnaSabri @RehearsalLot @guiscaesar @surfersnout @aedmondsauthor @barbiesway @TwitterMoments @RepMaxineWaters @PolitiFact True,320,12,332,2018-06-25
956,1011141668450361344,Mon Jun 25 06:58:54 +0000 2018,@RehearsalLot @guiscaesar @surfersnout @aedmondsauthor @barbiesway @TwitterMoments @RepMaxineWaters @PolitiFact We… https://t.co/nAiQNAnZof,693,81,774,2018-06-25
957,1011140501641224193,Mon Jun 25 06:54:16 +0000 2018,@RehearsalLot @guiscaesar @surfersnout @aedmondsauthor @barbiesway @TwitterMoments @RepMaxineWaters @PolitiFact “…… https://t.co/6QMC7Y3Cnh,420,33,453,2018-06-25
958,1011140130332028928,Mon Jun 25 06:52:47 +0000 2018,@RehearsalLot @guiscaesar @surfersnout @aedmondsauthor @barbiesway @TwitterMoments @RepMaxineWaters @PolitiFact “Al… https://t.co/3EyhzYyOSi,388,28,416,2018-06-25
959,1011139511625977856,Mon Jun 25 06:50:20 +0000 2018,@RehearsalLot @guiscaesar @surfersnout @aedmondsauthor @barbiesway @TwitterMoments @RepMaxineWaters @PolitiFact Thi… https://t.co/AouLpfRELJ,411,36,447,2018-06-25
960,1011139030476451840,Mon Jun 25 06:48:25 +0000 2018,"@GetMyGist As individuals, we will all die in blink of an eye on a galactic timescale. What can live on for long ti… https://t.co/MprPy4pPr8",2091,234,2325,2018-06-25
961,1011117367647260672,Mon Jun 25 05:22:20 +0000 2018,"RT @elonmusk: @xkcdComic This doesn’t take into account shifting trillions of tons of carbon from subsurface to atmosphere, which could acc…",0,459,459,2018-06-25
962,1011117284524519424,Mon Jun 25 05:22:00 +0000 2018,"@xkcdComic This doesn’t take into account shifting trillions of tons of carbon from subsurface to atmosphere, which… https://t.co/wAQszeOmUG",6279,459,6738,2018-06-25
963,1011115792182726656,Mon Jun 25 05:16:05 +0000 2018,"@bizwiz1980 @xkcdComic A billion at most, so 20% max. Still basically in the nick of time from an age-of-Earth standpoint.",678,16,694,2018-06-25
964,1011114786606731265,Mon Jun 25 05:12:05 +0000 2018,"@lazarusrang Humanity is not perfect, but it’s all we’ve got",783,97,880,2018-06-25
965,1011114443588194304,Mon Jun 25 05:10:43 +0000 2018,RT @elonmusk: @xkcdComic Could be very close call. Earth is ~4.5B years old &amp; sun will expand to heat Earth beyond livable temp in ~0.5B ye…,0,1121,1121,2018-06-25
966,1011114064737693697,Mon Jun 25 05:09:13 +0000 2018,@xkcdComic Could be very close call. Earth is ~4.5B years old &amp; sun will expand to heat Earth beyond livable temp i… https://t.co/uf4VLWkV6F,11016,1121,12137,2018-06-25
967,1011091725429850112,Mon Jun 25 03:40:27 +0000 2018,"@docjkcardinal @WorldAndScience Let’s find out. It would be amazing to encounter an alien civilization, provided it… https://t.co/3bPt1n1HwN",1738,85,1823,2018-06-25
968,1011089283547983875,Mon Jun 25 03:30:44 +0000 2018,@DMC_Ryan @tkraenze @Tesla Good news coming soon,663,42,705,2018-06-25
969,1011089136743170048,Mon Jun 25 03:30:09 +0000 2018,@Cardoso Yes,1369,30,1399,2018-06-25
970,1011087164250046465,Mon Jun 25 03:22:19 +0000 2018,"@thescalex Yes, we are essentially a steward of life &amp; duty-bound imo to ensure its continuance",817,58,875,2018-06-25
971,1011085606514880512,Mon Jun 25 03:16:08 +0000 2018,@Rossputin Life is good,882,72,954,2018-06-25
972,1011085383239589888,Mon Jun 25 03:15:15 +0000 2018,"It is unknown whether we are the only civilization currently alive in the observable universe, but any chance that… https://t.co/rZNEIU4iEe",23671,2628,26299,2018-06-25
973,1011083630301536256,Mon Jun 25 03:08:17 +0000 2018,This is why we must preserve the light of consciousness by becoming a spacefaring civilization &amp; extending life to… https://t.co/BKu7IPETSX,44173,7932,52105,2018-06-25
974,1011082171170242560,Mon Jun 25 03:02:29 +0000 2018,@WorldAndScience So strange,6906,281,7187,2018-06-25
975,1011081272930603008,Mon Jun 25 02:58:55 +0000 2018,"@DMC_Ryan @tkraenze @Tesla Critical autonomous safety features like emergency braking are standard, but convenience… https://t.co/zfhD74r6FY",460,19,479,2018-06-25
976,1011044846776168448,Mon Jun 25 00:34:10 +0000 2018,"@jclishman @Justin_Ebright It’s a tough call. Reality is that it will be pretty easy to bully a self-driving car, a… https://t.co/MDsE8ZAqNV",848,34,882,2018-06-25
977,1011043467575717888,Mon Jun 25 00:28:41 +0000 2018,"@Justin_Ebright We considered going beyond Mad Max to “LA Freeway” level, but that’s too loco",1511,59,1570,2018-06-25
978,1011039248386965504,Mon Jun 25 00:11:55 +0000 2018,It’s real https://t.co/L9h3F86Guo,19898,1806,21704,2018-06-25
979,1011028355314081792,Sun Jun 24 23:28:38 +0000 2018,@JohnnaSabri @kerra_henke @Kennnaughty Thanks!,322,11,333,2018-06-24
980,1011027339210317825,Sun Jun 24 23:24:36 +0000 2018,@FredericLambert Cyborg Dragon Tesla almost done,2280,144,2424,2018-06-24
981,1011021456526987266,Sun Jun 24 23:01:13 +0000 2018,Tesla Semi Truck in Mad Max Mode https://t.co/hL5v9rikhW,50017,6281,56298,2018-06-24
982,1010951918909181953,Sun Jun 24 18:24:54 +0000 2018,"@Kal5_ Almost forgot Sinclair ZX Spectrum &amp; Spectravideo before PC. Sinclair had amazing games, especially Elite.",635,29,664,2018-06-24
983,1010771114287554560,Sun Jun 24 06:26:27 +0000 2018,@Kal5_ Vic 20 -&gt; IBM PC,693,25,718,2018-06-24
984,1010727396046135297,Sun Jun 24 03:32:44 +0000 2018,"@kerra_henke @Kennnaughty 🚀 Road, Hawthorne",455,12,467,2018-06-24
985,1010722093963493376,Sun Jun 24 03:11:40 +0000 2018,@aidle @SchwartzReports .sus,2478,233,2711,2018-06-24
986,1010720136246919171,Sun Jun 24 03:03:53 +0000 2018,@Kennnaughty @kerra_henke 420 haha,742,120,862,2018-06-24
987,1010662970987171840,Sat Jun 23 23:16:44 +0000 2018,@ICannot_Enough He had a way with words,994,31,1025,2018-06-23
988,1010652684653813760,Sat Jun 23 22:35:51 +0000 2018,https://t.co/SiIkkugFyC,19465,1052,20517,2018-06-23
989,1010620550622822400,Sat Jun 23 20:28:10 +0000 2018,@SchwartzReports I was dying to use the word sus,11148,1505,12653,2018-06-23
990,1010619465715728384,Sat Jun 23 20:23:51 +0000 2018,@martinengwicht @MaxxABillion Working in the factory,464,21,485,2018-06-23
991,1010619095421616128,Sat Jun 23 20:22:23 +0000 2018,@Scobleizer @Trace_Cohen Expanding the tour soon. So many cool things to see. Tesla car factory has 3rd largest foo… https://t.co/6Ahg74BFVS,2554,97,2651,2018-06-23
992,1010596809616445440,Sat Jun 23 18:53:50 +0000 2018,Looks so sus when we paint cars red https://t.co/SIO2nInjhJ,82968,8502,91470,2018-06-23
993,1010595834122022913,Sat Jun 23 18:49:57 +0000 2018,@JimSholler Which rolls out today,459,13,472,2018-06-23
994,1010578767096438784,Sat Jun 23 17:42:08 +0000 2018,@JimSholler Will be there in next release,384,13,397,2018-06-23
995,1010497621390123009,Sat Jun 23 12:19:41 +0000 2018,@WorldAndScience So big you can’t believe it,19662,1173,20835,2018-06-23
996,1010468297186242566,Sat Jun 23 10:23:10 +0000 2018,srsly https://t.co/v9stLUFwg2,5887,404,6291,2018-06-23
997,1010459048485875713,Sat Jun 23 09:46:25 +0000 2018,Vicious torque,8086,286,8372,2018-06-23
998,1010458705513537536,Sat Jun 23 09:45:03 +0000 2018,Tesla factory rn https://t.co/EbgRDhRZ0m,19433,1277,20710,2018-06-23
999,1010431046460923905,Sat Jun 23 07:55:09 +0000 2018,#donotpanic,5690,352,6042,2018-06-23
1000,1010428377797308416,Sat Jun 23 07:44:32 +0000 2018,.@WidespreadPanic https://t.co/FTrXKmoGBC,11441,910,12351,2018-06-23
1001,1010407596103090176,Sat Jun 23 06:21:58 +0000 2018,@DMC_Ryan Good catch!,1428,29,1457,2018-06-23
1002,1010405602516799488,Sat Jun 23 06:14:02 +0000 2018,https://t.co/5CS4McZmPK,8853,822,9675,2018-06-23
1003,1010398829106028544,Sat Jun 23 05:47:07 +0000 2018,@Synapsesame Exactly 🤖♥️,337,9,346,2018-06-23
1004,1010393272529764352,Sat Jun 23 05:25:03 +0000 2018,What is my purpose? Sentient seats. https://t.co/s9aHHyDoud,59857,4531,64388,2018-06-23
1005,1010314704261017600,Sat Jun 23 00:12:50 +0000 2018,@DMC_Ryan @Kotaku @Tesla Thanks 🖤,583,16,599,2018-06-23
1006,1010284456337264640,Fri Jun 22 22:12:39 +0000 2018,"@DMC_Ryan @Kotaku At Fremont until late tonight, Giga tomorrow, Fremont Sunday. GA4 is great, but have to say that… https://t.co/et9eVVyu3G",901,67,968,2018-06-22
1007,1010279647622283264,Fri Jun 22 21:53:32 +0000 2018,"@Kotaku Infinity Work, the Reality game",7249,455,7704,2018-06-22
1008,1010252910775566336,Fri Jun 22 20:07:18 +0000 2018,RT @Hyperloop: .@SpaceX’s third Hyperloop Pod Competition is one month away. Fastest Pod wins! → https://t.co/LQXEAWbG1m,0,454,454,2018-06-22
1009,1010252871596560386,Fri Jun 22 20:07:08 +0000 2018,"RT @Hyperloop: More than 600 students from over 40 countries will demonstrate their Pod designs for a next-generation, high-speed transport…",0,1499,1499,2018-06-22
1010,1010224375339966464,Fri Jun 22 18:13:54 +0000 2018,"@FredericLambert @Model3Owners That would be tricky to sequence, but maybe",882,24,906,2018-06-22
1011,1010223743287771136,Fri Jun 22 18:11:24 +0000 2018,@Model3Owners Was thinking of offering an extended Tesla factory tour option where you could help build part of a c… https://t.co/H0Qti5bipn,16345,1133,17478,2018-06-22
1012,1010221659054174208,Fri Jun 22 18:03:07 +0000 2018,@disapr_ @cybik It’s called Top Secret,527,23,550,2018-06-22
1013,1010214875295989760,Fri Jun 22 17:36:09 +0000 2018,@cybik Yes,5304,266,5570,2018-06-22
1014,1010035029726990336,Fri Jun 22 05:41:31 +0000 2018,"@CateLuvsLondon @vicentes @S_Padival @bourgeoisalien @jacobinmag When I was a kid, I built model airplanes, trainse… https://t.co/PaAM3lpwfg",1775,114,1889,2018-06-22
1015,1010028341921964032,Fri Jun 22 05:14:56 +0000 2018,"@vicentes @S_Padival @bourgeoisalien @jacobinmag Yeah, but I’m not sure what the big deal is. I like building thing… https://t.co/4S7bPBE8oq",1463,60,1523,2018-06-22
1016,1010027258684174338,Fri Jun 22 05:10:38 +0000 2018,@ddkilzer @wk057 @Tesla We will add a config to lower the alert,399,15,414,2018-06-22
1017,1010027104275087360,Fri Jun 22 05:10:01 +0000 2018,@wk057 @Tesla Apply light force to the steering wheel. Alert is being changed to this text.,2977,54,3031,2018-06-22
1018,1010005390283567104,Fri Jun 22 03:43:44 +0000 2018,@hectorramos Try saying “bug report”. Might work better. Ironic if the bug report about bug reports isn’t working :),500,16,516,2018-06-22
1019,1010004813310877698,Fri Jun 22 03:41:27 +0000 2018,"@zaphodgjd Thanks for the feedback, will investigate",448,12,460,2018-06-22
1020,1009997025432068096,Fri Jun 22 03:10:30 +0000 2018,RT @Tesla: ☀️ https://t.co/J6mdP7rCV4,0,2191,2191,2018-06-22
1021,1009972020749012992,Fri Jun 22 01:31:08 +0000 2018,@corywright Sure,309,6,315,2018-06-22
1022,1009971757959090176,Fri Jun 22 01:30:06 +0000 2018,@ToscaMusk @westcoastbill @PassionFlix @RachVD @itsNickBateman Congratulations!,834,20,854,2018-06-22
1023,1009970334592716801,Fri Jun 22 01:24:26 +0000 2018,@S_Padival @bourgeoisalien @jacobinmag It’s actually pretty fun building electric cars. Product is useful to other… https://t.co/vkhw7o1Xxu,2475,114,2589,2018-06-22
1024,1009950544490741761,Fri Jun 22 00:05:48 +0000 2018,"@jacobinmag Btw, if anyone else wants to build this tunnel, please do so. It’s a lot of work.",9926,511,10437,2018-06-22
1025,1009940354097807360,Thu Jun 21 23:25:18 +0000 2018,@jacobinmag Stop being such a Jacobin 🐈🧙‍♂️,1958,68,2026,2018-06-21
1026,1009618544403808265,Thu Jun 21 02:06:33 +0000 2018,Frank Herbert &amp; Falcon Heavy,8530,341,8871,2018-06-21
1027,1009613082770001920,Thu Jun 21 01:44:51 +0000 2018,"Without change, something sleeps inside us, and seldom awakens. The sleeper must awaken. FH … https://t.co/FjW31RPSqh",43138,6433,49571,2018-06-21
1028,1009605123117670400,Thu Jun 21 01:13:13 +0000 2018,Dune. The spice must flow. https://t.co/WjVUX0gfuH,33411,3601,37012,2018-06-21
1029,1009603495476031494,Thu Jun 21 01:06:45 +0000 2018,https://t.co/8nnlWHUjXw,13462,733,14195,2018-06-21
1030,1009596699675725824,Thu Jun 21 00:39:45 +0000 2018,@mayemusk @georgezachary @kimbal @ToscaMusk “We power the press” in 1997. Ironic.,2140,93,2233,2018-06-21
1031,1009581267434663936,Wed Jun 20 23:38:25 +0000 2018,RT @Tesla: Tesla Semi driving to Santa Rosa https://t.co/5Gdk4WAJcE,0,5209,5209,2018-06-20
1032,1009580339008684033,Wed Jun 20 23:34:44 +0000 2018,"RT @SpaceX: Crew Dragon is at @NASA’s Plum Brook Station testing facility in Ohio, home to the largest thermal vacuum chamber in the world,…",0,2830,2830,2018-06-20
1033,1009571180989243392,Wed Jun 20 22:58:21 +0000 2018,@Money23Green Thanks for coming by our car factory with @westcoastbill. Tesla team was super fired up to see you! Congrats on your victory!!,7152,365,7517,2018-06-20
1034,1009559662549598208,Wed Jun 20 22:12:34 +0000 2018,"@georgezachary @kimbal Crazy, that was over 22 years ago. Thanks for believing in us!",2928,78,3006,2018-06-20
1035,1009484066159144962,Wed Jun 20 17:12:11 +0000 2018,"@cfarivar There is more, but the actions of a few bad apples will not stop Tesla from reaching its goals. With 40,0… https://t.co/3yQhufzQH2",628,59,687,2018-06-20
1036,1009482786934177793,Wed Jun 20 17:07:06 +0000 2018,@erikbryn @vplikeTRUMP @jorendewachter @xJawz @joerogan @MazzucatoM Today. It’s kinda there in US with welfare but… https://t.co/gLZdZwiAYX,520,36,556,2018-06-20
1037,1009481756133580800,Wed Jun 20 17:03:00 +0000 2018,@vplikeTRUMP @jorendewachter @xJawz @joerogan @MazzucatoM Also think there should be a universal basic income that… https://t.co/edPmqV8Tjh,892,127,1019,2018-06-20
1038,1009471275113123840,Wed Jun 20 16:21:21 +0000 2018,@adultswim Because honey is a vegetable,7100,546,7646,2018-06-20
1039,1009363765098250240,Wed Jun 20 09:14:09 +0000 2018,@Santiago7K @xJawz @joerogan Considerably less so than our competitors (longer discussion),468,18,486,2018-06-20
1040,1009362316536602625,Wed Jun 20 09:08:23 +0000 2018,"@vplikeTRUMP @jorendewachter @xJawz @joerogan @MazzucatoM Yes, consumption tax is way better. Also, higher estate t… https://t.co/2h4gbsimxJ",598,37,635,2018-06-20
1041,1009353114938298368,Wed Jun 20 08:31:50 +0000 2018,@PeacefulChaos7 @DanAloni @xJawz @joerogan Exactly,336,12,348,2018-06-20
1042,1009352456021553152,Wed Jun 20 08:29:13 +0000 2018,@jorendewachter @xJawz @joerogan @MazzucatoM He’s obv wrong. Forcing function for any 100% mkt share monopolist to… https://t.co/6mocDhWaRw,397,16,413,2018-06-20
1043,1009349553667989505,Wed Jun 20 08:17:41 +0000 2018,@EvilCorpGame Great name. A little on the nose.,1877,37,1914,2018-06-20
1044,1009349201677803520,Wed Jun 20 08:16:17 +0000 2018,"@DanAloni @xJawz @joerogan That’s really decision about how good you think govt is at allocating capital. Buffett,… https://t.co/FB0GP7y0cz",580,45,625,2018-06-20
1045,1009346561946480641,Wed Jun 20 08:05:47 +0000 2018,"@xJawz @joerogan Yeah, all-inclusive tax rate of 40% seems about right. Below 30% is unrealistic for critical govt… https://t.co/d93T2dJtYr",4424,235,4659,2018-06-20
1046,1009213703995121664,Tue Jun 19 23:17:51 +0000 2018,Cool video https://t.co/FW24TRL687,7367,588,7955,2018-06-19
1047,1009200969253511168,Tue Jun 19 22:27:15 +0000 2018,Thank you for helping those in need https://t.co/GF7b3y7MLr,21236,1437,22673,2018-06-19
1048,1009164260151185408,Tue Jun 19 20:01:23 +0000 2018,"@TopDutchCom @pascal_munz @Zuckerberger @horn To be clear, Tesla European Headquarters will remain in Netherlands",641,70,711,2018-06-19
1049,1009105044061413377,Tue Jun 19 16:06:05 +0000 2018,@bonnienorman Yup,1131,27,1158,2018-06-19
1050,1009018120634187776,Tue Jun 19 10:20:41 +0000 2018,"@FilmLadd That’s ridiculous, lions can’t vote, they don’t even have opposable thumbs. Also, they’d need 61%, so no.",9085,459,9544,2018-06-19
1051,1009014824280342529,Tue Jun 19 10:07:35 +0000 2018,@pascal_munz @Zuckerberger @horn Germany is a leading choice for Europe. Perhaps on the German-French border makes… https://t.co/QHyGOHevVJ,1253,153,1406,2018-06-19
1052,1009012996192890880,Tue Jun 19 10:00:19 +0000 2018,@horn @LudaLisl @Hermes42 Brevity is the sole meunière of wit,338,16,354,2018-06-19
1053,1009011461924876288,Tue Jun 19 09:54:13 +0000 2018,@light00bringer @horn Original Star Wars,623,28,651,2018-06-19
1054,1009011170156556288,Tue Jun 19 09:53:04 +0000 2018,@XxMrFredzzik @horn Hahaha,414,10,424,2018-06-19
1055,1009010411041984513,Tue Jun 19 09:50:03 +0000 2018,"@LudaLisl @horn Die fröhliche Wissenschaft und Eristische Dialektik: Die Kunst, Recht zu Behalten",507,31,538,2018-06-19
1056,1009007159470780416,Tue Jun 19 09:37:07 +0000 2018,@Zuckerberger @horn Das war ein unbeabsichtigter Witz ⛪ 🌃 🤗,1064,39,1103,2018-06-19
1057,1008995895986171904,Tue Jun 19 08:52:22 +0000 2018,@horn Vielleicht muss ich die Kirche im Dorf verlassen?,3817,349,4166,2018-06-19
1058,1008976232510152704,Tue Jun 19 07:34:14 +0000 2018,@cyantist @1world22gether Will do. Am enquiring on many channels. Regards to Scott.,525,16,541,2018-06-19
1059,1008974776633659392,Tue Jun 19 07:28:27 +0000 2018,@1world22gether @cyantist Do you know anyone who has gone there?,364,7,371,2018-06-19
1060,1008974007259938821,Tue Jun 19 07:25:23 +0000 2018,@cyantist Where are they?,2029,129,2158,2018-06-19
1061,1008969670840311814,Tue Jun 19 07:08:09 +0000 2018,@ManInTheHoody @backrowgracie @jgalerstein @somospostpc @RAICESTEXAS @ACLU Where are you going to march?,1028,46,1074,2018-06-19
1062,1008968815630258176,Tue Jun 19 07:04:46 +0000 2018,@dstressdotcom @Chellie0020 @backrowgracie @jgalerstein @somospostpc @RAICESTEXAS @ACLU That seems unlikely,339,8,347,2018-06-19
1063,1008968645391810560,Tue Jun 19 07:04:05 +0000 2018,@backrowgracie @jgalerstein @somospostpc @RAICESTEXAS @ACLU Just because I donate doesn’t mean I support every last… https://t.co/n6n7T0SxbO,1780,64,1844,2018-06-19
1064,1008963854624350210,Tue Jun 19 06:45:03 +0000 2018,@jgalerstein @somospostpc @RAICESTEXAS @ACLU I am one of the top donors to @ACLU,4801,241,5042,2018-06-19
1065,1008960448681660417,Tue Jun 19 06:31:31 +0000 2018,"@somospostpc I couldn’t even keep the US in the Paris Accord, but if there is some way for me to help these kids I will do so",4921,378,5299,2018-06-19
1066,1008958747312558080,Tue Jun 19 06:24:45 +0000 2018,@sasimons @etlonmusk I think so,338,8,346,2018-06-19
1067,1008953199963746304,Tue Jun 19 06:02:42 +0000 2018,I hope the kids are ok,10972,869,11841,2018-06-19
1068,1008952872375967744,Tue Jun 19 06:01:24 +0000 2018,Shelter https://t.co/bLVrv0WpJb,8261,644,8905,2018-06-19
1069,1008935738270834689,Tue Jun 19 04:53:19 +0000 2018,@AntVenom @cfarivar @amendlocke You’re probably right. Maybe after Tesla drama calms down.,1129,51,1180,2018-06-19
1070,1008935327124213760,Tue Jun 19 04:51:41 +0000 2018,@cfarivar @PPathole @dawg_fan_93 @maysacha @JayPrisefighter @EBRPD I’m at the factory a lot. Pretty good workout ju… https://t.co/kBD6oC9AvH,448,17,465,2018-06-19
1071,1008920527673516032,Tue Jun 19 03:52:53 +0000 2018,@cfarivar @PPathole @dawg_fan_93 @maysacha @JayPrisefighter They look beautiful,370,9,379,2018-06-19
1072,1008920523038867456,Tue Jun 19 03:52:52 +0000 2018,@cfarivar @loosecoosebbq @akrdu2 @Tesla @Fremont_CA Will maybe do a media tour next week. Team deserves recognition. This was miraculous.,618,44,662,2018-06-19
1073,1008919193259945986,Tue Jun 19 03:47:35 +0000 2018,@PPathole @dawg_fan_93 @maysacha @JayPrisefighter @cfarivar It’s actually way better than the factory building. Mor… https://t.co/QMtg8iImqH,544,30,574,2018-06-19
1074,1008916455948148736,Tue Jun 19 03:36:42 +0000 2018,@maysacha @JayPrisefighter @cfarivar Not sure we actually need a building. This tent is pretty sweet. Tesla Grohman… https://t.co/FHxoXdg5i1,803,65,868,2018-06-19
1075,1008913670707953664,Tue Jun 19 03:25:38 +0000 2018,@JayPrisefighter @cfarivar They also poured the concrete &amp; built the whole assembly line using scrap we had in ware… https://t.co/AO3LNbtsKZ,1015,47,1062,2018-06-19
1076,1008912705737056256,Tue Jun 19 03:21:48 +0000 2018,@joshsteimle @monongahelaEX @AntVenom No,362,12,374,2018-06-19
1077,1008906878795968514,Tue Jun 19 02:58:39 +0000 2018,"RT @elonmusk: @cfarivar Needed another general assembly line to reach 5k/week Model 3 production. A new building was impossible, so we buil…",0,744,744,2018-06-19
1078,1008906087611883521,Tue Jun 19 02:55:30 +0000 2018,"@cfarivar Needed another general assembly line to reach 5k/week Model 3 production. A new building was impossible,… https://t.co/NfXknwvUQ3",13438,744,14182,2018-06-19
1079,1008872597780508673,Tue Jun 19 00:42:25 +0000 2018,"@scottlynch78 @jenphalian You’re welcome, bad fiction writer 78 https://t.co/ypglGbdEse",356,9,365,2018-06-19
1080,1008860403051327488,Mon Jun 18 23:53:58 +0000 2018,"@cfarivar @amendlocke Dude, we are California, which is extremely pro union. People can form a union tomorrow &amp; not… https://t.co/IjkYegwb0P",1009,80,1089,2018-06-18
1081,1008859105883066368,Mon Jun 18 23:48:49 +0000 2018,@amendlocke Your union brothers https://t.co/DsGvlscvc6,1887,236,2123,2018-06-18
1082,1008858642550943745,Mon Jun 18 23:46:58 +0000 2018,@amendlocke You won’t find pro-union either. The books are all about freedom. No one is forced to join any organization.,2676,102,2778,2018-06-18
1083,1008566142724497408,Mon Jun 18 04:24:41 +0000 2018,"@Keith_Wasserman @Jason @Beyonce @warriors Thanks, good advice",677,19,696,2018-06-18
1084,1008450201885872129,Sun Jun 17 20:43:58 +0000 2018,@FredericLambert @SwiftOnSecurity They have about three weeks before their short position explodes,1745,295,2040,2018-06-17
1085,1008445877197783040,Sun Jun 17 20:26:47 +0000 2018,@c7five Good points. Already mostly working in the developer software I’m driving.,536,23,559,2018-06-17
1086,1008445446975512576,Sun Jun 17 20:25:05 +0000 2018,@iamJeffTorres @thehartej @yaronbrook @VitalikButerin @RickandMorty Can’t wait for the new @RickandMorty season to start!,710,66,776,2018-06-17
1087,1008443957603258368,Sun Jun 17 20:19:10 +0000 2018,"@goombar3 We’ve always provided healthcare, hourly wages above union &amp; Tesla stock. Also, free drinks &amp; snacks. Try… https://t.co/hujSfnTwHf",984,84,1068,2018-06-17
1088,1008441697506754560,Sun Jun 17 20:10:11 +0000 2018,@taimurstriker Glad you teach physics. That and critical thinking (ie how not to be tricked) are foundational for all kids to learn.,7868,418,8286,2018-06-17
1089,1008439719900766208,Sun Jun 17 20:02:19 +0000 2018,"@iamJeffTorres @thehartej @yaronbrook @VitalikButerin Yeah, I think we pretty much agree. Btw, great show.",416,12,428,2018-06-17
1090,1008438394559451136,Sun Jun 17 19:57:03 +0000 2018,"@iamJeffTorres @thehartej @yaronbrook @VitalikButerin I think essential services, incl health care, should be taken… https://t.co/3nfoF0wszO",802,76,878,2018-06-17
1091,1008437057700544512,Sun Jun 17 19:51:45 +0000 2018,@mk_rodgers They started it &amp; attacked me personally,1218,48,1266,2018-06-17
1092,1008435606714662912,Sun Jun 17 19:45:59 +0000 2018,Search UAW and “corruption”. Very long reading list. Great organization. https://t.co/9RVR31vzbc,6366,876,7242,2018-06-17
1093,1008431653935435776,Sun Jun 17 19:30:16 +0000 2018,@iamJeffTorres @thehartej @yaronbrook @VitalikButerin “Profit” just means you earned more money than you spent &amp; ce… https://t.co/bSSonsktRa,836,92,928,2018-06-17
1094,1008427324298022912,Sun Jun 17 19:13:04 +0000 2018,@SwiftOnSecurity They don’t seem to think much or care about the future beyond a narrow horizon,926,57,983,2018-06-17
1095,1008423993999650816,Sun Jun 17 18:59:50 +0000 2018,@haymarketbooks Engels wrote 2nd &amp; 3rd volumes based on Marx’s “notes”. Less reliable.,862,34,896,2018-06-17
1096,1008423357774102528,Sun Jun 17 18:57:18 +0000 2018,"@SwiftOnSecurity Wanted to help transition the world to sustainable, clean energy and extend life as we know it bey… https://t.co/evNsbjDwCG",947,87,1034,2018-06-17
1097,1008422418753339392,Sun Jun 17 18:53:34 +0000 2018,"@doctorow @sahazel Wow, you know nothing &amp; are worthy of contempt. The world is under massive attack due to climate… https://t.co/tr8zog4eCj",447,29,476,2018-06-17
1098,1008421697354018816,Sun Jun 17 18:50:42 +0000 2018,"@JohnnaSabri @slack2thefuture @doctorow Read it. Like the green, translucent Martian opal?",342,15,357,2018-06-17
1099,1008419464067440641,Sun Jun 17 18:41:50 +0000 2018,@JohnnaSabri @slack2thefuture @doctorow Iron pyrite,368,9,377,2018-06-17
1100,1008418903448477696,Sun Jun 17 18:39:36 +0000 2018,@JimPuzzanghera Congratulations to LA Times and Patrick Soon-Shiong!,797,28,825,2018-06-17
1101,1008411784603099136,Sun Jun 17 18:11:19 +0000 2018,"@spookyozzy @slack2thefuture @doctorow You’re just a troll/bot, but I will reply anyway. I arrived in Montreal at 1… https://t.co/BC3GTZFv2I",671,53,724,2018-06-17
1102,1008410980898914304,Sun Jun 17 18:08:07 +0000 2018,@TeslaCharts I don’t want to see anyone lose their money. Or I will at least provide fair warning before it happens… https://t.co/YxnYEBcimR,689,57,746,2018-06-17
1103,1008409974299508736,Sun Jun 17 18:04:07 +0000 2018,@slack2thefuture @doctorow You think all companies are bad and all unions good? That’s a very bigoted position.,575,45,620,2018-06-17
1104,1008409208092438528,Sun Jun 17 18:01:05 +0000 2018,Well said https://t.co/lDPaIPLLzO,33847,5961,39808,2018-06-17
1105,1008407906268602368,Sun Jun 17 17:55:54 +0000 2018,@TeslaCharts Then you’ll be fine,477,23,500,2018-06-17
1106,1008406652431654912,Sun Jun 17 17:50:55 +0000 2018,@JohnnaSabri @indiemusicfan9 @dimas_______ @Robotbeat @doctorow Exactly. Our NDA is actually shorter &amp; simpler than most.,349,14,363,2018-06-17
1107,1008406329398980608,Sun Jun 17 17:49:38 +0000 2018,@indiemusicfan9 @dimas_______ @Robotbeat @doctorow ...which clearly doesn’t work. UAW and Wall Street shorts know e… https://t.co/Pb3trRlHxW,385,26,411,2018-06-17
1108,1008405624068104192,Sun Jun 17 17:46:50 +0000 2018,"@doctorow @dimas_______ @Robotbeat Then look a little closer, doctorow. Read the whole thread.",270,6,276,2018-06-17
1109,1008404991516631040,Sun Jun 17 17:44:19 +0000 2018,@indiemusicfan9 @dimas_______ @Robotbeat @doctorow More propaganda. The NDA only prevents disclosure of Tesla propr… https://t.co/vCGmWGqukO,400,18,418,2018-06-17
1110,1008404147584921600,Sun Jun 17 17:40:58 +0000 2018,@TeslaCharts How big is your short position? Just curious.,770,122,892,2018-06-17
1111,1008403122207612928,Sun Jun 17 17:36:54 +0000 2018,@BobbieBees @dimas_______ @Robotbeat @doctorow Union flyers are handed out all the time in the factory. I know beca… https://t.co/gteobKIMUj,345,16,361,2018-06-17
1112,1008401637528895488,Sun Jun 17 17:31:00 +0000 2018,"@doctorow I endorse freedom to form a union too, as well as freedom not to do so if they feel Tesla is a good compa… https://t.co/jKXZcm8tXK",509,19,528,2018-06-17
1113,1008397942653218816,Sun Jun 17 17:16:19 +0000 2018,@dimas_______ @Robotbeat @doctorow UAW doesn’t have 30% of signatures (about 6000 people) needed for a vote. They c… https://t.co/XJOvPNRJ2J,597,37,634,2018-06-17
1114,1008393868381843456,Sun Jun 17 17:00:07 +0000 2018,"@TheSithSeth @doctorow I’m not against all unions, but UAW has a track record of destroying productivity so a compa… https://t.co/goje54dysT",485,34,519,2018-06-17
1115,1008392599210561537,Sun Jun 17 16:55:05 +0000 2018,"@Robotbeat @doctorow I am too, of sorts. Govt (ie other taxpayers) should take care of critical needs of people, in… https://t.co/zOqnEzBJxD",513,32,545,2018-06-17
1116,1008390757596581888,Sun Jun 17 16:47:46 +0000 2018,"@AntVenom @Shaynooooo @kausthav_ray @SpaceX Was originally called Puff the Magic Dragon, as people said I was high… https://t.co/ab6I8FQdmZ",743,40,783,2018-06-17
1117,1008389798740963329,Sun Jun 17 16:43:57 +0000 2018,@doctorow Iain certainly wasn’t pro-union in the Culture books. At all. And wouldn’t be in the case of Tesla. Banks… https://t.co/7vBWtUzZlg,837,37,874,2018-06-17
1118,1008386640685850624,Sun Jun 17 16:31:24 +0000 2018,@Shaynooooo @kausthav_ray @SpaceX https://t.co/sYo8iIodjG,626,35,661,2018-06-17
1119,1008385171744174080,Sun Jun 17 16:25:34 +0000 2018,@leechy3 @kausthav_ray @SpaceX SX 300 &amp; soon SX 500. Kind of a modern version of Inconel superalloys. High strength… https://t.co/pCNdOMWU3i,606,43,649,2018-06-17
1120,1008382743606988800,Sun Jun 17 16:15:55 +0000 2018,"@kausthav_ray @SpaceX Structures, engines, avionics, guidance &amp; control software, new alloys, space lasers (ooh, ma… https://t.co/VC3CQ0MopP",13592,764,14356,2018-06-17
1121,1008381974266798080,Sun Jun 17 16:12:52 +0000 2018,@mayemusk @kimbal Love you too 💕,2187,55,2242,2018-06-17
1122,1008326131798269952,Sun Jun 17 12:30:58 +0000 2018,@johngoo 👽🧚‍♀️🚀🍃🍄🍕🍕🍕,668,41,709,2018-06-17
1123,1008324562663043074,Sun Jun 17 12:24:44 +0000 2018,@RealMariaLOVE Fair point,640,10,650,2018-06-17
1124,1008318961539137537,Sun Jun 17 12:02:28 +0000 2018,"Auto-semiotic asphyxiation (sorry, couldn’t resist)",5154,248,5402,2018-06-17
1125,1008315086903996417,Sun Jun 17 11:47:04 +0000 2018,@AntVenom And I don’t trust that Engels guy. He could have made up most of 2nd &amp; 3rd volumes. Nobody actually knows.,736,89,825,2018-06-17
1126,1008314270096896000,Sun Jun 17 11:43:50 +0000 2018,@drgitlin Your math isn’t very good. Would require 61%. And what’s your issue anyway? Better suggestions are welcome.,2577,91,2668,2018-06-17
1127,1008191818788302849,Sun Jun 17 03:37:15 +0000 2018,The Semi-erotics of Evil https://t.co/g1pffKexRJ,10565,1752,12317,2018-06-17
1128,1008176356033814528,Sun Jun 17 02:35:48 +0000 2018,@thetomzone I dare you to stop following me. Do it.,2673,81,2754,2018-06-17
1129,1008175546830938113,Sun Jun 17 02:32:36 +0000 2018,@Wi_Writer Ok,6224,704,6928,2018-06-17
1130,1008170402969841664,Sun Jun 17 02:12:09 +0000 2018,The enemy of my enemy is myself https://t.co/momMBAEuzU,74209,9453,83662,2018-06-17
1131,1008166534399680513,Sun Jun 17 01:56:47 +0000 2018,@worldout_42 @Billsocalif @fnord3125 Exactly,333,11,344,2018-06-17
1132,1008164588867555329,Sun Jun 17 01:49:03 +0000 2018,@Alix_SS @ZhouChauster Libertinarian,919,36,955,2018-06-17
1133,1008124944289370113,Sat Jun 16 23:11:31 +0000 2018,"@michaelshermer Direct democracy by the people. Laws must be short, as there is trickery in length. Automatic expir… https://t.co/kFyYiYOXsw",19998,2623,22621,2018-06-16
1134,1008122748361568257,Sat Jun 16 23:02:47 +0000 2018,@rknDA1337 @FredoDeSmet The mind sacrificing itself in the final ship battle,884,27,911,2018-06-16
1135,1008121639337320454,Sat Jun 16 22:58:23 +0000 2018,"@FredoDeSmet All of them, especially Surface Detail",1446,47,1493,2018-06-16
1136,1008120904759402501,Sat Jun 16 22:55:28 +0000 2018,"If you must know, I am a utopian anarchist of the kind best described by Iain Banks",35103,3392,38495,2018-06-16
1137,1008114586392846336,Sat Jun 16 22:30:21 +0000 2018,@AbeDurrani @NelStamp @RRescenko @peterthiel I disagree with that goal &amp; gave away Tesla patents to help other comp… https://t.co/H3tIT3o1Re,582,43,625,2018-06-16
1138,1008111802448777216,Sat Jun 16 22:19:18 +0000 2018,"@NelStamp @RRescenko If I’m not a communist, why do I make red cars 🚘 🤔",878,102,980,2018-06-16
1139,1008109905209843712,Sat Jun 16 22:11:45 +0000 2018,@kikkerin @soniasimone Very appealing if you’re a sophomore in college. It’s a counterpoint to communism and useful… https://t.co/dWYXDmI8ra,672,25,697,2018-06-16
1140,1008107926895185921,Sat Jun 16 22:03:54 +0000 2018,@Gubisoul @monongahelaEX @AntVenom That is why it is critical to support competition. Excess profits draw in compet… https://t.co/6LM5KKj51j,1421,120,1541,2018-06-16
1141,1008102269944860672,Sat Jun 16 21:41:25 +0000 2018,@soniasimone lol,1133,63,1196,2018-06-16
1142,1008101573472354304,Sat Jun 16 21:38:39 +0000 2018,"@monongahelaEX @AntVenom Read Das Kapital when I was 14, incl cross-checking English translation of original German… https://t.co/D1n2eoZ2ur",2087,203,2290,2018-06-16
1143,1008083495107772416,Sat Jun 16 20:26:49 +0000 2018,@Model3Owners @DMC_Ryan Might actually be his!,1279,26,1305,2018-06-16
1144,1008081295090450432,Sat Jun 16 20:18:04 +0000 2018,Amazing work by Tesla team. Built entire new general assembly line in 3 weeks w minimal resources. Love u guys so m… https://t.co/ow1XhgnQZF,50387,4831,55218,2018-06-16
1145,1008079815667113984,Sat Jun 16 20:12:11 +0000 2018,@fnord3125 You’re a docile puppet of the UAW. Be honest about what you are.,484,13,497,2018-06-16
1146,1008078826386087936,Sat Jun 16 20:08:16 +0000 2018,@christapeterso Yes,284,8,292,2018-06-16
1147,1008014213741150208,Sat Jun 16 15:51:31 +0000 2018,@NickAPappas Sigh,2174,45,2219,2018-06-16
1148,1008013111058526209,Sat Jun 16 15:47:08 +0000 2018,"By the way, I am actually a socialist. Just not the kind that shifts resources from most productive to least produc… https://t.co/w187fY1aW5",45612,6123,51735,2018-06-16
1149,1008012300979077121,Sat Jun 16 15:43:55 +0000 2018,"“No sense of humor” is certainly proving itself true. Good grief!
How many socialists does it take to screw in a li… https://t.co/kAhUtGlkGe",54472,6517,60989,2018-06-16
1150,1008009529223598081,Sat Jun 16 15:32:54 +0000 2018,"@R850Mango @tinytacotown Boys High is a government school for anyone local, which we were",512,9,521,2018-06-16
1151,1007787229500936192,Sat Jun 16 00:49:33 +0000 2018,RT @elonmusk: @KevinOConnorNBA Lake Show,0,900,900,2018-06-16
1152,1007787164308869120,Sat Jun 16 00:49:18 +0000 2018,@KevinOConnorNBA Lake Show,5576,900,6476,2018-06-16
1153,1007780580396683267,Sat Jun 16 00:23:08 +0000 2018,"Heading back into the factory, so that’s enough for now. Don’t take my Tweet too seriously. For one thing, it’s called a “Tweet”.",27424,1738,29162,2018-06-16
1154,1007775323822460929,Sat Jun 16 00:02:15 +0000 2018,@elmaddogg @tinytacotown No,293,5,298,2018-06-16
1155,1007774899556028416,Sat Jun 16 00:00:34 +0000 2018,@tinytacotown My father has no money. Only reason he even has a house is because my brother &amp; I bought it for him o… https://t.co/xQ2MyhS7HI,2229,107,2336,2018-06-16
1156,1007769302836174849,Fri Jun 15 23:38:19 +0000 2018,"RT @elonmusk: @CarltonTSC There is considerable confusion between wealth as consumption &amp; wealth as labor allocation. By latter measure, an…",0,1608,1608,2018-06-15
1157,1007768708779999237,Fri Jun 15 23:35:58 +0000 2018,@CarltonTSC There is considerable confusion between wealth as consumption &amp; wealth as labor allocation. By latter m… https://t.co/ZuU3ljl09Q,11484,1608,13092,2018-06-15
1158,1007766450256392192,Fri Jun 15 23:26:59 +0000 2018,Socialism vs capitalism is not even the right question. What really matters is avoiding monopolies that restrict people’s freedom.,114247,25345,139592,2018-06-15
1159,1007762646182047744,Fri Jun 15 23:11:52 +0000 2018,@Jack_Frodo Universal income will be necessary over time if AI takes over most human jobs,7387,823,8210,2018-06-15
1160,1007758296336330753,Fri Jun 15 22:54:35 +0000 2018,@AntVenom Marx was a capitalist. He even wrote a book about it.,9729,2679,12408,2018-06-15
1161,1007757625646182400,Fri Jun 15 22:51:55 +0000 2018,@AntVenom A socialist,17903,1572,19475,2018-06-15
1162,1007752686878388224,Fri Jun 15 22:32:18 +0000 2018,"Those who proclaim themselves “socialists” are usually depressing, have no sense of humor &amp; attended an expensive college. Fate loves irony.",179274,44820,224094,2018-06-15
1163,1007680749326065664,Fri Jun 15 17:46:27 +0000 2018,@publicfreeman @BlackSocialists What is yours?,376,10,386,2018-06-15
1164,1007680326934585344,Fri Jun 15 17:44:46 +0000 2018,@BlackSocialists What is your utopia?,505,49,554,2018-06-15
1165,1007679828303024128,Fri Jun 15 17:42:47 +0000 2018,@MobiiliMika The future is a set of branching probability streams. Some actions by humanity have an extremely lever… https://t.co/wyO3NzYY1D,1496,209,1705,2018-06-15
1166,1007669712539414528,Fri Jun 15 17:02:35 +0000 2018,@FernandoGords68 @BillNye @neiltyson Strongly disagree. I love humanity.,725,45,770,2018-06-15
1167,1007669485065547776,Fri Jun 15 17:01:41 +0000 2018,"@LanceUlanoff @lea_bitterwolf @jlgolson Already did. Meant to go longer, but ran out of time. https://t.co/s8g76wTqLl",2610,290,2900,2018-06-15
1168,1007668628794175489,Fri Jun 15 16:58:17 +0000 2018,@lea_bitterwolf @jlgolson I always wanted to do a terms &amp; conditions cover of Green Eggs &amp; Ham,1383,52,1435,2018-06-15
1169,1007668113591005184,Fri Jun 15 16:56:14 +0000 2018,@gcortes Foundation Series &amp; Zeroth Law are fundamental to creation of SpaceX,1226,108,1334,2018-06-15
1170,1007667617060941824,Fri Jun 15 16:54:16 +0000 2018,@PaulVerstegen1 I love Banks. Best books in recent years imo are Iain Banks &amp; George Martin.,824,58,882,2018-06-15
1171,1007667079892254720,Fri Jun 15 16:52:08 +0000 2018,"@jlgolson Given how bad I am at poetry, probably Vogon",2326,90,2416,2018-06-15
1172,1007665949044928517,Fri Jun 15 16:47:38 +0000 2018,Should prob articulate philosophy underlying my actions. It’s pretty simple &amp; mostly influenced by Douglas Adams &amp; Isaac Asimov.,28728,2548,31276,2018-06-15
1173,1007664788325818369,Fri Jun 15 16:43:01 +0000 2018,@annerajb @FredericLambert My donations are anonymous,2380,99,2479,2018-06-15
1174,1007663283648647169,Fri Jun 15 16:37:02 +0000 2018,@FredericLambert Already sold &gt;$100M TSLA for charity. Will do about that every few years. Major disbursements in a… https://t.co/crzHdiU8TU,2606,174,2780,2018-06-15
1175,1007647898161463297,Fri Jun 15 15:35:54 +0000 2018,"My “pay” is in options, which only matter if stock goes up &amp; I sell. Will use that to make life multiplanetary, hel… https://t.co/WQzKv7j5HI",81917,14513,96430,2018-06-15
1176,1007359366008328193,Thu Jun 14 20:29:23 +0000 2018,RT @boringcompany: Green lights to Malibu https://t.co/wsBcE2FwTe,0,3947,3947,2018-06-14
1177,1007148112484462592,Thu Jun 14 06:29:56 +0000 2018,RT @boringcompany: We’re really excited to work with the Mayor and the City to bring this new high-speed public transportation system to Ch…,0,4378,4378,2018-06-14
1178,1007137868190502912,Thu Jun 14 05:49:14 +0000 2018,RT @business: Solar surpasses gas and wind as the biggest source of new power in the U.S. https://t.co/gJ4IkmbrQa https://t.co/VM50YDyPjZ,0,3143,3143,2018-06-14
1179,1007076304095625216,Thu Jun 14 01:44:36 +0000 2018,@ralphbakshi Dankonia,11440,1096,12536,2018-06-14
1180,1006968985760366592,Wed Jun 13 18:38:09 +0000 2018,@korihale @Tesla @CultureBanx @Forbes We use less than 3% cobalt in our batteries &amp; will use none in next gen,13610,964,14574,2018-06-13
1181,1006951781069291521,Wed Jun 13 17:29:47 +0000 2018,"@kwang0429 Yes, interface will change with Version 9 software",678,34,712,2018-06-13
1182,1006755636141424640,Wed Jun 13 04:30:22 +0000 2018,"@ifnd323 Will be adjusting screen alert to clarify that we mean “slight up or downward force on the wheel”, not really “hold the wheel”",520,22,542,2018-06-13
1183,1006643600891842561,Tue Jun 12 21:05:11 +0000 2018,"@arctechinc Some very, very tough calls. Had to let go of good people, but I think they will find new jobs quickly.",2481,75,2556,2018-06-12
1184,1006597562156003328,Tue Jun 12 18:02:15 +0000 2018,"Difficult, but necessary Tesla reorg underway. My email to the company has already leaked to media. Here it is unfi… https://t.co/oP4buaF9ZS",72382,10920,83302,2018-06-12
1185,1006312299244605441,Mon Jun 11 23:08:43 +0000 2018,@NabilZouhir1 @mayemusk @kimbal That is actual footage,885,30,915,2018-06-11
1186,1006311825833541632,Mon Jun 11 23:06:50 +0000 2018,@mayemusk @kimbal Back in the Precambrian era when the main form of life was a sponge,945,50,995,2018-06-11
1187,1005951447169581056,Sun Jun 10 23:14:49 +0000 2018,@joerogan @Off_thewalls @MKBHD Thanks! Have heard universally great things about your podcasts.,9949,567,10516,2018-06-10
1188,1005907548476588032,Sun Jun 10 20:20:23 +0000 2018,"@garyflickinger @OchamsRazr @VR0NLINE Of course, but it’s the kind of hustle that you like even with full knowledge… https://t.co/PiJbm1sg7y",712,28,740,2018-06-10
1189,1005904638137139200,Sun Jun 10 20:08:49 +0000 2018,@Erdayastronaut @Lord_Lima_Bean @UHDDreamer @LanceUlanoff Trade is just that Roadster becomes a 2 seater instead of… https://t.co/NWrXpbd9cf,1014,59,1073,2018-06-10
1190,1005902575353204736,Sun Jun 10 20:00:37 +0000 2018,@Lord_Lima_Bean @UHDDreamer @LanceUlanoff Exactly. Total energy stored even in ultra compressed air is low vs batte… https://t.co/qEiOFD7axB,996,71,1067,2018-06-10
1191,1005900081793359872,Sun Jun 10 19:50:42 +0000 2018,@Caio_1999_ @LanceUlanoff Not recommended for urban environments,633,24,657,2018-06-10
1192,1005899638665240576,Sun Jun 10 19:48:57 +0000 2018,@ThatGuyKnapp @LanceUlanoff Yes,630,20,650,2018-06-10
1193,1005899053551370240,Sun Jun 10 19:46:37 +0000 2018,@poriya_ravi @WorldAndScience The actual amount of time I spend on Twitter is tiny. My tweets are literally what I’… https://t.co/rhkPCpPnqv,1624,190,1814,2018-06-10
1194,1005896761091604480,Sun Jun 10 19:37:31 +0000 2018,@oheather1337 @WorldAndScience It is amazingly hard to find a simple solution. A complicated one is relatively easy.,1218,125,1343,2018-06-10
1195,1005884215039176704,Sun Jun 10 18:47:39 +0000 2018,@WorldAndScience Love this design. Simpler the better.,15021,490,15511,2018-06-10
1196,1005879678895177729,Sun Jun 10 18:29:38 +0000 2018,@DeeLex_MCEM @VHollywood21 Add an R for Roadster 👽💕🚀,624,25,649,2018-06-10
1197,1005879049493725186,Sun Jun 10 18:27:08 +0000 2018,"@raptorweb Sigh. This is crux of matter: can’t make system too annoying or people won’t use it, negatively affectin… https://t.co/QnNfjs9coM",612,29,641,2018-06-10
1198,1005877098035048448,Sun Jun 10 18:19:23 +0000 2018,@Off_thewalls @MKBHD @joerogan A lot of people whose judgment I respect have suggested this. Sounds like a good ide… https://t.co/41gKPV14LV,6586,332,6918,2018-06-10
1199,1005876491345752064,Sun Jun 10 18:16:58 +0000 2018,"@VHollywood21 Yes. Hopefully, I’m not tempting fate too much with that date. It was meant as a joke, but is about the right actual timing.",566,23,589,2018-06-10
1200,1005875421999554560,Sun Jun 10 18:12:43 +0000 2018,@MKBHD Will do,11755,370,12125,2018-06-10
1201,1005874658015522816,Sun Jun 10 18:09:41 +0000 2018,"@bartjehoel @djenkins6 Correct, pure electric. Wish orbital rockets could be so too, but there’s no escaping Newton… https://t.co/24t3dh5zCD",1341,120,1461,2018-06-10
1202,1005788654386606080,Sun Jun 10 12:27:56 +0000 2018,"@MKBHD You have my word, Marques. Next gen Roadster will be absolutely out of this world. For those who love to dri… https://t.co/dCHM2bnPlU",17957,1169,19126,2018-06-10
1203,1005785859558273024,Sun Jun 10 12:16:50 +0000 2018,"@LanceUlanoff Note, gas contained would be ultra high pressure air in a SpaceX rocket COPV bottle. The air exiting… https://t.co/lYexqJK7Ul",3469,212,3681,2018-06-10
1204,1005784176950370305,Sun Jun 10 12:10:09 +0000 2018,"@LanceUlanoff Intent of new Tesla Roadster is to beat gas sports cars on every performance metric by far, no except… https://t.co/ytNsLLBKHs",5531,446,5977,2018-06-10
1205,1005782088841232385,Sun Jun 10 12:01:51 +0000 2018,@anandrajk @lexiheft @Tesla That issue is better in latest Autopilot software rolling out now &amp; fully fixed in Augu… https://t.co/hlA9kLcYPY,1069,158,1227,2018-06-10
1206,1005699514630471680,Sun Jun 10 06:33:43 +0000 2018,This is why I’m not impressed when reporters who were literally in junior high while I was in newsrooms all round t… https://t.co/DScG4rWbg6,26314,2444,28758,2018-06-10
1207,1005695924318842880,Sun Jun 10 06:19:27 +0000 2018,Zip2 also built a newspaper publishing platform that brought hundreds of regional &amp; city papers online for the firs… https://t.co/F7zKQ0rHGx,12711,815,13526,2018-06-10
1208,1005662117796540416,Sun Jun 10 04:05:07 +0000 2018,@trace_remick @FredericLambert 20 years of intense programming on extremely weak CPUs with nothing for memory &amp; a s… https://t.co/OttCNWgisM,830,48,878,2018-06-10
1209,1005643673353064448,Sun Jun 10 02:51:50 +0000 2018,"@FredericLambert In early 90s, I wrote a multitasker for PCs that spoofed the CPU &amp; CD-ROM to act in parallel, so c… https://t.co/1m3DWrF63w",1165,90,1255,2018-06-10
1210,1005639487995592705,Sun Jun 10 02:35:12 +0000 2018,"@FredericLambert That’s quite a blast from the past! After my Zip2 experience w patents, I felt that patents (parti… https://t.co/8Xq35e8aCQ",1043,118,1161,2018-06-10
1211,1005596879848030209,Sat Jun 09 23:45:53 +0000 2018,"At Zip2, I wrote entire V1 of software for drawing vector maps &amp; calculating point to point directions anywhere in… https://t.co/sDSKHFYc4D",16602,1257,17859,2018-06-09
1212,1005593651219582977,Sat Jun 09 23:33:04 +0000 2018,"More background: I arrived in North America at 17 w $2000, a backpack &amp; a suitcase full of books. Paid my own way t… https://t.co/X3RtmAELCx",31752,4461,36213,2018-06-09
1213,1005591117557989377,Sat Jun 09 23:23:00 +0000 2018,"@FrankIppolito @boringcompany We don’t think our product will be the cause of any wildfires, but The Boring Company is donating $10k.",5226,192,5418,2018-06-09
1214,1005585154373386240,Sat Jun 09 22:59:18 +0000 2018,"@djenkins6 Using the config you describe, plus an electric pump to replenish air in COPV, when car power draw drops… https://t.co/V3IoCWlB0l",2502,120,2622,2018-06-09
1215,1005582744980606976,Sat Jun 09 22:49:43 +0000 2018,"19 years ago, when my 1st company got bought, I had to decide between buying a house in Palo Alto or a McLaren F1 (… https://t.co/FFkx8AseVJ",27348,3234,30582,2018-06-09
1216,1005577738332172289,Sat Jun 09 22:29:50 +0000 2018,SpaceX option package for new Tesla Roadster will include ~10 small rocket thrusters arranged seamlessly around car… https://t.co/w5AdnC49iu,64884,9558,74442,2018-06-09
1217,1005574277578481664,Sat Jun 09 22:16:05 +0000 2018,"RT @Tesla: Tesla’s 10000th Supercharger is now open in Belleville, Ontario: https://t.co/lqJMwRaxxH https://t.co/E4iY4vfAiH",0,2265,2265,2018-06-09
1218,1005564275656568832,Sat Jun 09 21:36:20 +0000 2018,"Terms &amp; conditions for “Not-a-Flamethrower”

Please use as directed to avoid unintentionally burning things down. F… https://t.co/ge9P9XW1Cp",48938,9814,58752,2018-06-09
1219,1005553979386880000,Sat Jun 09 20:55:25 +0000 2018,Almost forgot! Due to recent regulatory/customs rules enacted to inhibit transport of anything called a Flamethrowe… https://t.co/Ir6Qnyq1uu,110114,14703,124817,2018-06-09
1220,1005550302831861761,Sat Jun 09 20:40:49 +0000 2018,@darth_schmoo Yes,1841,80,1921,2018-06-09
1221,1005550181054443520,Sat Jun 09 20:40:20 +0000 2018,"@SPPhotonic Each flamethrower comes with a state-of-the-art The Boring Company brand fire extinguisher. 

Will offe… https://t.co/h3cElY9xWG",3196,188,3384,2018-06-09
1222,1005549006573846528,Sat Jun 09 20:35:40 +0000 2018,"Flamethrower obv best way to light your fireplace/BBQ. No more need to use a dainty “match” to ignite! If no wood,… https://t.co/s8NIE0fdnk",25927,2808,28735,2018-06-09
1223,1005544620854349824,Sat Jun 09 20:18:14 +0000 2018,@teslamarcus1 Coming soon,365,17,382,2018-06-09
1224,1005544618207744000,Sat Jun 09 20:18:13 +0000 2018,@mikesidneyphoto I think so :),340,8,348,2018-06-09
1225,1005537267912400896,Sat Jun 09 19:49:01 +0000 2018,Nothing makes your baby more zen than a few gentle puffs of a TBC Flamethrower https://t.co/HewJf66hh2,23731,2378,26109,2018-06-09
1226,1005535664366968832,Sat Jun 09 19:42:38 +0000 2018,First 1000 Boring Company Flamethrowers being picked up today! https://t.co/hBMp5fGzAB,72717,9206,81923,2018-06-09
1227,1005139802826526720,Fri Jun 08 17:29:38 +0000 2018,@teslaology @DMC_Ryan @Tesla We’re building out Tesla body repair in all major metro areas to ensure super fast &amp; excellent outcome,791,61,852,2018-06-08
1228,1005138469243383808,Fri Jun 08 17:24:20 +0000 2018,@DMC_Ryan Talked with Tesla team. Looks like we can do the aluminum Model 3 pedal covers (slightly different from S… https://t.co/M4AhlGA1Si,914,72,986,2018-06-08
1229,1005133546665566208,Fri Jun 08 17:04:46 +0000 2018,@pmnordkvist Gigafactory should be on 100% renewable energy (primarily solar with some wind) by next year. Rollout of solar already begun.,7862,507,8369,2018-06-08
1230,1005120018340765696,Fri Jun 08 16:11:01 +0000 2018,"@Nate_072 @SpaceX Yeah, actually closer to Skylab, but with 50% larger inner diameter",1078,34,1112,2018-06-08
1231,1004937668612898817,Fri Jun 08 04:06:25 +0000 2018,And we’re definitely going to have a pod bay door override button. Lesson learned.,33696,2351,36047,2018-06-08
1232,1004937330409418753,Fri Jun 08 04:05:05 +0000 2018,@MKBHD Definitely. Will also have Augmented Mode that will massively enhance human driving ability. Like a flying m… https://t.co/Wxf0C6MJ0k,13545,775,14320,2018-06-08
1233,1004936605797212160,Fri Jun 08 04:02:12 +0000 2018,Running track in @SpaceX BF Spaceship will look something like this https://t.co/563upTfV58,54506,7807,62313,2018-06-08
1234,1004866833822842882,Thu Jun 07 23:24:57 +0000 2018,"@DMC_Ryan No plans for aluminum pedals. Adds too much production complexity. Model 3 will def have summon, which wi… https://t.co/ngAXQ8uuVC",751,45,796,2018-06-07
1235,1004864184998170624,Thu Jun 07 23:14:25 +0000 2018,RT @Tesla: Switching 1 million cars from diesel to electric would save over £360 ($483) million per year in health costs in the UK,0,3443,3443,2018-06-07
1236,1004857328120709120,Thu Jun 07 22:47:11 +0000 2018,@jovanik21 @Tesla Working on improving,461,16,477,2018-06-07
1237,1004835436508819456,Thu Jun 07 21:20:11 +0000 2018,RT @Tesla: .@teslaownersau created a charging network across Australia so you can travel from your home to P. Sherman 42 Wallaby Way in a s…,0,2281,2281,2018-06-07
1238,1004816355948806144,Thu Jun 07 20:04:22 +0000 2018,"@ElliottGotkine No way 6 mins is enough for abs. I mean, come on, 7 mins is obv right.",509,12,521,2018-06-07
1239,1004794907377090560,Thu Jun 07 18:39:08 +0000 2018,"@dprzygoda Oh please, that’s obv overkill",810,19,829,2018-06-07
1240,1004792846182801408,Thu Jun 07 18:30:57 +0000 2018,Tip of the day … https://t.co/MjbYlseX45,14556,1090,15646,2018-06-07
1241,1004655455233138688,Thu Jun 07 09:25:00 +0000 2018,"RT @kylegossman: Hey @elonmusk, pls cancel my Model 3 service appt for tomorrow. Vincent from tech ops texted me and fixed it in my drivewa…",0,1101,1101,2018-06-07
1242,1004212406849978368,Wed Jun 06 04:04:29 +0000 2018,@lexiheft @Tesla Coming soon,1132,40,1172,2018-06-06
1243,1004167764590788609,Wed Jun 06 01:07:06 +0000 2018,"@shwetp We are ramping production as fast as possible. Wait should be closer to 6 months though, not 2 years.",647,29,676,2018-06-06
1244,1004134357420859394,Tue Jun 05 22:54:21 +0000 2018,RT @Tesla: Model 3 is now the best-selling mid-sized premium sedan in the USA https://t.co/xI7LsgRI6D,0,5990,5990,2018-06-05
1245,1004112168227241984,Tue Jun 05 21:26:11 +0000 2018,RT @Tesla: Watch the Tesla Shareholders Meeting live at 2:30pm PT: https://t.co/KRgSMMYIvw,0,444,444,2018-06-05
1246,1004097702693502976,Tue Jun 05 20:28:42 +0000 2018,"RT @Tesla: We have now installed over 1 gigawatt-hour of energy storage across the globe
https://t.co/9PJhOFPy5Y",0,1723,1723,2018-06-05
1247,1004081880340168704,Tue Jun 05 19:25:49 +0000 2018,@WSJ Congratulations @murraymatt. Good move by @WSJ. Please use Matt’s Twitter pic. Essence of a good editor,1896,66,1962,2018-06-05
1248,1003916871693791232,Tue Jun 05 08:30:08 +0000 2018,"@ang3lwtf Yup, we are extending the net area by a factor of 4",835,48,883,2018-06-05
1249,1003725887756386304,Mon Jun 04 19:51:14 +0000 2018,"Am def not under any illusion that this will end illiteracy, but I hope it helps at least a little https://t.co/06IA9Xy6bL",24986,2922,27908,2018-06-04
1250,1003701407004758016,Mon Jun 04 18:13:57 +0000 2018,"@sonic_hedgehog Good morning, Sonic. Not sure how to break it to you, but … https://t.co/RPpOchBMKJ",32702,4896,37598,2018-06-04
1251,1003549006234963977,Mon Jun 04 08:08:22 +0000 2018,RT @SpaceX: Successful deployment of SES-12 to a geostationary transfer orbit confirmed.,0,1681,1681,2018-06-04
1252,1003374877439430656,Sun Jun 03 20:36:27 +0000 2018,RT @SpaceX: Falcon 9 and SES-12 went vertical this morning on Pad 40 in Florida. Weather is 70% favorable for the four-hour launch window w…,0,1640,1640,2018-06-03
1253,1003161965533937667,Sun Jun 03 06:30:25 +0000 2018,"@SquarePeg44 @cassianelwes We have about 11,000 projects underway in Puerto Rico",1599,270,1869,2018-06-03
1254,1003158520919814145,Sun Jun 03 06:16:43 +0000 2018,@cassianelwes Appreciated on behalf of Tesla team,5184,141,5325,2018-06-03
1255,1003143895599812608,Sun Jun 03 05:18:36 +0000 2018,RT @Tesla: In 8 years we've gone from building 500 vehicles per year in California to 100k+ and growing https://t.co/WoKjLYJcqU,0,2189,2189,2018-06-03
1256,1003142348061138944,Sun Jun 03 05:12:27 +0000 2018,@Jamie_Sullivan4 @Model3Owners You should get an invite to configure in next few days,486,19,505,2018-06-03
1257,1003142058738049025,Sun Jun 03 05:11:18 +0000 2018,@MacTechGenius @Model3Owners Definitely,521,16,537,2018-06-03
1258,1003142000307154944,Sun Jun 03 05:11:05 +0000 2018,"@Heretic_Soul @Model3Owners Leasing negatively effects Tesla cash flow, so we prob won’t offer Model 3 leases for 6… https://t.co/g31KV22ARI",598,44,642,2018-06-03
1259,1003139875112042497,Sun Jun 03 05:02:38 +0000 2018,@Model3Owners Model 3 Performance order page progressively rolling out to reservation holders over the next week or… https://t.co/xUzY6TMI0G,4388,262,4650,2018-06-03
1260,1002983121896103937,Sat Jun 02 18:39:45 +0000 2018,@RReardonT @Tesla Next year,1588,29,1617,2018-06-02
1261,1002982393467158528,Sat Jun 02 18:36:51 +0000 2018,@heron_ziegel @jasminrohman Twitter is so dark …,4101,242,4343,2018-06-02
1262,1002981936233496577,Sat Jun 02 18:35:02 +0000 2018,@jkunkel2 No … no …,1315,27,1342,2018-06-02
1263,1002981810379284480,Sat Jun 02 18:34:32 +0000 2018,@jasminrohman That is horrifying,4277,95,4372,2018-06-02
1264,1002981547836764160,Sat Jun 02 18:33:30 +0000 2018,"@AlexGuichet Indeed, the esthetics of cutlery are a source of great stress",2278,79,2357,2018-06-02
1265,1002980786977402880,Sat Jun 02 18:30:28 +0000 2018,Mason jars with a handle or wine stem cause me to lose faith in humanity,52732,6262,58994,2018-06-02
1266,1002945324858552320,Sat Jun 02 16:09:33 +0000 2018,@RacusinJennifer @tycoonmindset05 The future,1994,88,2082,2018-06-02
1267,1002945018066157568,Sat Jun 02 16:08:20 +0000 2018,@SpiritosoV @KumJm @STcom Exactly!,510,16,526,2018-06-02
1268,1002944786913873922,Sat Jun 02 16:07:25 +0000 2018,@tycoonmindset05 I was an alien 🛸👽♥️💫,34090,3445,37535,2018-06-02
1269,1002943252704591872,Sat Jun 02 16:01:19 +0000 2018,"@DanielaAtHome8 Usually, they don’t even realize it. All they know is that some PR agency is pushing a story that w… https://t.co/mmp2cPnMnc",560,46,606,2018-06-02
1270,1002942317785853953,Sat Jun 02 15:57:36 +0000 2018,@NathanWickland @STcom Actually true!,559,15,574,2018-06-02
1271,1002941578040696832,Sat Jun 02 15:54:40 +0000 2018,@KumJm @STcom Singapore has enough land area to generate most of its electricity from the sun. Solar energy is more… https://t.co/BrgSBEuWec,937,208,1145,2018-06-02
1272,1002939845755334662,Sat Jun 02 15:47:47 +0000 2018,"@STcom But don’t worry, cars have been tested for emissions levels &amp; everything’s just fine https://t.co/cg4ooQSrX3",731,56,787,2018-06-02
1273,1002938604623196160,Sat Jun 02 15:42:51 +0000 2018,@STcom Why have policies that promote a combustion vehicle fleet in a dense city environment? In bumper to bumper t… https://t.co/q79llzDL4j,1089,220,1309,2018-06-02
1274,1002926869069553664,Sat Jun 02 14:56:13 +0000 2018,@STcom The results speak for themselves. Singapore is a very prosperous city and yet has very few electric cars.,4731,491,5222,2018-06-02
1275,1002682587800690688,Fri Jun 01 22:45:32 +0000 2018,Glad you’re ok! https://t.co/zuuYCUIKus,48451,3132,51583,2018-06-01
1276,1002678650355920896,Fri Jun 01 22:29:53 +0000 2018,Some details on the Tesla air filtration system https://t.co/kRPwg7TGsu,7875,651,8526,2018-06-01
1277,1002669489366822912,Fri Jun 01 21:53:29 +0000 2018,RT @roadshow: 'Unboxing' my new Tesla Model 3 https://t.co/2XIxwwZQU2 https://t.co/YdNMmiFohW,0,350,350,2018-06-01
1278,1002467202430144512,Fri Jun 01 08:29:40 +0000 2018,@nickg_uk Mid 2019 for RHD,460,21,481,2018-06-01
1279,1002466064230334464,Fri Jun 01 08:25:09 +0000 2018,@nashlib That sounds like a fun adventure!,426,14,440,2018-06-01
1280,1002465751859490816,Fri Jun 01 08:23:54 +0000 2018,@nickg_uk You can just take the aero inserts out of the standard wheel &amp; it looks pretty cool. We could offer that as an option at purchase.,445,10,455,2018-06-01
1281,1002381189607350272,Fri Jun 01 02:47:53 +0000 2018,"@Arkved78 Model 3 should be second best in world after Model S/X. Still super good, but we went a little 🥜 on S/X.",1670,56,1726,2018-06-01
1282,1002380587389390848,Fri Jun 01 02:45:30 +0000 2018,"Filters bacteria, viruses, spores, pollen &amp; particulate of almost any kind https://t.co/dlQHJfKdpU",17873,1791,19664,2018-06-01
1283,1002379548804206592,Fri Jun 01 02:41:22 +0000 2018,"@Seanmmvi @OlofTenghoff @Tesla Model S &amp; X also have an acid gas filter, an alkaline gas filter &amp; a carbon monoxide… https://t.co/zHOXWYB5gC",4983,568,5551,2018-06-01
1284,1002372757366149121,Fri Jun 01 02:14:23 +0000 2018,RT @NASA: We’re opening our doors for social media users to come behind-the-scenes for the next @SpaceX cargo launch to the International @…,0,1605,1605,2018-06-01
1285,1002372491514441728,Fri Jun 01 02:13:19 +0000 2018,"Cool, Tesla S/X have hospital operating room air quality when BWD mode is activated, so shd protect against even a… https://t.co/wY1NYnh3in",49494,6711,56205,2018-06-01
1286,1002357778818592769,Fri Jun 01 01:14:52 +0000 2018,@jimcramer @BrianSozzi Do it,40931,4113,45044,2018-06-01
1287,1002284769114079232,Thu May 31 20:24:45 +0000 2018,@CandybarLaMuse Berliner Wurst hat am meisten Curry🔥,1403,277,1680,2018-05-31
1288,1002283316840574976,Thu May 31 20:18:58 +0000 2018,@gyano @DrTie1 @Poxari Ich habe an der Universität ein Semester Deutsch studiert. Ich wünschte ich könnte es besser sprechen!,2792,355,3147,2018-05-31
1289,1002273494564913153,Thu May 31 19:39:57 +0000 2018,@DrTie1 @Poxari Natürlich,1879,122,2001,2018-05-31
1290,1002272887892361216,Thu May 31 19:37:32 +0000 2018,@FredericLambert Definitely,1198,63,1261,2018-05-31
1291,1002270980755013632,Thu May 31 19:29:57 +0000 2018,Best analysis of Model 3 to date (German) https://t.co/kCd3qWODiR,10441,1108,11549,2018-05-31
1292,1002245552002641920,Thu May 31 17:48:55 +0000 2018,Finders keepers 🚀🚀🚀 https://t.co/zyV71zRIFQ,48432,4170,52602,2018-05-31
1293,1002237545273483264,Thu May 31 17:17:06 +0000 2018,#Pravduh https://t.co/ZlMp13WOxW,5568,459,6027,2018-05-31
1294,1002198347006922754,Thu May 31 14:41:20 +0000 2018,@Malala Hi @Malala! 💕👻😅,45318,2603,47921,2018-05-31
1295,1002095592267370497,Thu May 31 07:53:01 +0000 2018,"RT @Tesla: Lots of Model 3 deliveries today in Toronto and more tomorrow. Vancouver next 🇨🇦 
https://t.co/TFb4ZDUZum",0,873,873,2018-05-31
1296,1002056802127638528,Thu May 31 05:18:53 +0000 2018,@unicorn @MacTechGenius @v_g_fischer @ConsumerReports Try adjusting tire pressure. Will ask Tesla engineering to investigate.,509,9,518,2018-05-31
1297,1002041479777406976,Thu May 31 04:18:00 +0000 2018,Hell of a week https://t.co/jKsfykkG55,165160,27196,192356,2018-05-31
1298,1002040126673948672,Thu May 31 04:12:37 +0000 2018,@Edwardpumps Just for perspective https://t.co/ZfMR1aOinY,3087,165,3252,2018-05-31
1299,1002037312094654465,Thu May 31 04:01:26 +0000 2018,"@johnny0129 @jeffnesbit @Tesla True, no one is perfect",502,13,515,2018-05-31
1300,1001955381734715394,Wed May 30 22:35:53 +0000 2018,@JeffreyWolder @jeffnesbit @Tesla You’re most welcome. More to come in this regard.,645,23,668,2018-05-30
1301,1001955221365456896,Wed May 30 22:35:14 +0000 2018,RT @CRcars: Consumer Reports tested the @Tesla Model 3 and found an issue with brakes. @elonmusk quickly responded. Our car has been update…,0,566,566,2018-05-30
1302,1001954916569579520,Wed May 30 22:34:02 +0000 2018,@jeffnesbit @Tesla Tesla will always refute articles that are misleading &amp; point out if there is someone with a pat… https://t.co/YpPITScGBD,6293,317,6610,2018-05-30
1303,1001903414555492352,Wed May 30 19:09:23 +0000 2018,"@ElectrekCo @FredericLambert Ride comfort &amp; aero/road noise already better than CR car, which was early production.… https://t.co/xdHsmqkocc",3556,180,3736,2018-05-30
1304,1001902483172507650,Wed May 30 19:05:41 +0000 2018,@annerajb @Henry_Pivac Prob 8.3,479,15,494,2018-05-30
1305,1001902212052758530,Wed May 30 19:04:36 +0000 2018,@Henry_Pivac Yes,414,7,421,2018-05-30
1306,1001870372403167232,Wed May 30 16:58:05 +0000 2018,All items below will go to all Model 3s within next few months with V8.2 software. To report a bug or ask for a fea… https://t.co/c1EbJImKT7,7196,631,7827,2018-05-30
1307,1001866971204349952,Wed May 30 16:44:34 +0000 2018,RT @elonmusk: @MacTechGenius @v_g_fischer @ConsumerReports Braking &amp; UI upgrades apply to all Model 3s. Improved windshield for aero noise…,0,155,155,2018-05-30
1308,1001866336732041222,Wed May 30 16:42:03 +0000 2018,@prakash_d @grillick @IndianInterest “Pneumatic” means propelled by air. Opposite of Hyperloop.,634,25,659,2018-05-30
1309,1001865846338215936,Wed May 30 16:40:06 +0000 2018,@MacTechGenius @v_g_fischer @ConsumerReports Braking &amp; UI upgrades apply to all Model 3s. Improved windshield for a… https://t.co/nBz2yB5ovw,2882,155,3037,2018-05-30
1310,1001863391982505984,Wed May 30 16:30:21 +0000 2018,"@v_g_fischer @ConsumerReports Yeah, absolutely",809,13,822,2018-05-30
1311,1001863039308595201,Wed May 30 16:28:56 +0000 2018,Really appreciate the high quality critical feedback from @ConsumerReports. Road noise &amp; ride comfort already addre… https://t.co/e3tAmTNnob,11127,995,12122,2018-05-30
1312,1001858830832029696,Wed May 30 16:12:13 +0000 2018,Like you guys too 🚘 🖤 https://t.co/PVQVyR1nXY,15427,704,16131,2018-05-30
1313,1001857257254993921,Wed May 30 16:05:58 +0000 2018,"@IndianInterest Actually, Hyperloop draws a near vacuum in tube &amp; each pod is powered w electric motors. It is oppo… https://t.co/NtHi7pQeQF",5578,331,5909,2018-05-30
1314,1001836681845092353,Wed May 30 14:44:12 +0000 2018,"RT @ElectrekCo: Tesla Model 3 owner says vehicle ‘performed miraculously’ in high-speed rear-end crash, all occupants are safe https://t.co…",0,1440,1440,2018-05-30
1315,1001707195799621632,Wed May 30 06:09:40 +0000 2018,"@yoyovinzi Would love to be in India. Some challenging government regulations, unfortunately. Deepak Ahuja, our CFO… https://t.co/D83zXYnCOB",5255,1864,7119,2018-05-30
1316,1001565360783474688,Tue May 29 20:46:04 +0000 2018,@annerajb @eli_schiff Good progress. Really proud of this design &amp; SpaceX propulsion team. This engine is something special.,1144,63,1207,2018-05-29
1317,1001564349465411584,Tue May 29 20:42:03 +0000 2018,@eli_schiff Peace ✌️,675,32,707,2018-05-29
1318,1001536562327252992,Tue May 29 18:51:38 +0000 2018,@ClaytonGoobert Love the space cowboy esthetic,2832,110,2942,2018-05-29
1319,1001534820894175232,Tue May 29 18:44:43 +0000 2018,@AndreaSJames ♥️,1835,48,1883,2018-05-29
1320,1001532526878310400,Tue May 29 18:35:36 +0000 2018,"At risk of stating the extremely obvious, I am against threats of violence &amp; abusive epithets in any forum. Please… https://t.co/dbku2At4zE",61040,4530,65570,2018-05-29
1321,1001523976542146560,Tue May 29 18:01:38 +0000 2018,"@kevinmgill You’re saying a BBC reporter who attacked me for months w unprofessional language &amp; ad hominem attacks,… https://t.co/f31JWvzvWO",12729,769,13498,2018-05-29
1322,1001520578581286913,Tue May 29 17:48:07 +0000 2018,"RT @EsotericCD: I am a big @ElonMusk /Tesla skeptic, but there is something deeply rotten about that DailyBeast article attacking him becau…",0,2185,2185,2018-05-29
1323,1001520405738213376,Tue May 29 17:47:26 +0000 2018,RT @elonmusk: @NoahShachtman @thedailybeast @erinbiba This journalist has been attacking me for months incl using genitalia language that s…,0,938,938,2018-05-29
1324,1001520305565675520,Tue May 29 17:47:02 +0000 2018,"RT @mayemusk: .@elonmusk You have grown up with female scientists around you all your life. We are honest, intelligent, and work hard to do…",0,1311,1311,2018-05-29
1325,1001516537344225281,Tue May 29 17:32:04 +0000 2018,@NoahShachtman @thedailybeast @erinbiba This journalist has been attacking me for months incl using genitalia langu… https://t.co/RbHRxqM9d8,8338,938,9276,2018-05-29
1326,1001509671776210944,Tue May 29 17:04:47 +0000 2018,"@HahTse @neilhimself @AnozieUdemezue @upulie @davidkfried “Nano” is a unit of measure, not a field imo. Would’ve be… https://t.co/7l1wFNGwzk",854,45,899,2018-05-29
1327,1001507474946560000,Tue May 29 16:56:03 +0000 2018,"@NoahShachtman @thedailybeast @erinbiba Hello, have you met the Internet? Everyone gets harassed regardless of gend… https://t.co/AIbEHhIR2C",6301,718,7019,2018-05-29
1328,1001504431521878017,Tue May 29 16:43:58 +0000 2018,"@neilhimself @AnozieUdemezue @upulie @davidkfried Gaiman, did you actually read my tweets? I didn’t set anyone on a… https://t.co/315qsrQFta",999,53,1052,2018-05-29
1329,1001391226988388353,Tue May 29 09:14:08 +0000 2018,@NoahShachtman @thedailybeast @erinbiba You’ve done something incredibly dishonest by supporting a journo who false… https://t.co/VVIE8o1wPA,39876,4041,43917,2018-05-29
1330,1001344881007079424,Tue May 29 06:09:58 +0000 2018,@amasad @its_a_massacre @fung9815 @israrayyaz @Sra_Mister @waitbutwhy Great book. Read it when it came out.,512,15,527,2018-05-29
1331,1001342504640307201,Tue May 29 06:00:31 +0000 2018,@amasad @its_a_massacre @fung9815 @israrayyaz @Sra_Mister @waitbutwhy Exactly,504,18,522,2018-05-29
1332,1001316038267432960,Tue May 29 04:15:21 +0000 2018,@rhinopIasty SpaceX has Area 58 at Cape Canaveral. That’s 7 better than 51.,2556,269,2825,2018-05-29
1333,1001315811582066688,Tue May 29 04:14:27 +0000 2018,@amasad @Sra_Mister Yeah,569,10,579,2018-05-29
1334,1001315130196410369,Tue May 29 04:11:45 +0000 2018,@amasad @Sra_Mister Second best answer to the Fermi Paradox after the simulation argument,1106,45,1151,2018-05-29
1335,1001314495581503488,Tue May 29 04:09:13 +0000 2018,@JohnnaSabri @Sra_Mister Which part? Love their cuisine. And the views are amazing.,821,30,851,2018-05-29
1336,1001314155150721024,Tue May 29 04:07:52 +0000 2018,@PPathole @Sra_Mister Yes,636,22,658,2018-05-29
1337,1001313907154108416,Tue May 29 04:06:53 +0000 2018,"@Sra_Mister There are no aliens. Officially, at least …",22228,1522,23750,2018-05-29
1338,1001313268369997825,Tue May 29 04:04:21 +0000 2018,@WorldAndScience You have so many great pics &amp; factoids!,11532,258,11790,2018-05-29
1339,1001261305804673024,Tue May 29 00:37:52 +0000 2018,"@G_Whitehead5 @DMC_Ryan @Model3Owners @Tesla Yes, AWD P first and then AWD. Production costs are always high when l… https://t.co/bFeXImrQRk",606,35,641,2018-05-29
1340,1001255940417470469,Tue May 29 00:16:33 +0000 2018,@davidtayar5 @annerajb @LikeTeslaKim I really want to make this cupholder,814,29,843,2018-05-29
1341,1001255278828965888,Tue May 29 00:13:55 +0000 2018,@annerajb @LikeTeslaKim A dream that wd prob be a nightmare in reality. Cup holder that auto adjusted for size &amp; st… https://t.co/fwGIoytVdH,1360,110,1470,2018-05-29
1342,1001253688755671040,Tue May 29 00:07:36 +0000 2018,@LikeTeslaKim I’ve literally had dreams about cup holder designs,1001,59,1060,2018-05-29
1343,1001253431493910528,Tue May 29 00:06:35 +0000 2018,@LikeTeslaKim Noted. We can prob adjust spring force &amp; catch to be less sensitive. Cupholders are amazingly hard to get right!,755,20,775,2018-05-29
1344,1001245477839429634,Mon May 28 23:34:58 +0000 2018,@JohnnaSabri @AffinPub @thesmelloftea You’re welcome. Appreciate the letter.,660,14,674,2018-05-28
1345,1001245302769180673,Mon May 28 23:34:17 +0000 2018,@nealcol Good school,501,14,515,2018-05-28
1346,1001240912691789825,Mon May 28 23:16:50 +0000 2018,Thank you for the lovely letter https://t.co/xGNMj5FOhg,9903,595,10498,2018-05-28
1347,1001238934825779201,Mon May 28 23:08:58 +0000 2018,@StarVenge @ChiTownMadison @JohnnaSabri @joshuatopolsky @oneunderscore__ @ParkerMolloy @2sunsky @ashleyfeinberg Had… https://t.co/VnSQ9EpbkM,593,9,602,2018-05-28
1348,1001238197500719108,Mon May 28 23:06:03 +0000 2018,@ChiTownMadison @JohnnaSabri @joshuatopolsky @oneunderscore__ @ParkerMolloy @2sunsky @ashleyfeinberg Yes,1159,19,1178,2018-05-28
1349,1001233031405780993,Mon May 28 22:45:31 +0000 2018,@joshuatopolsky @oneunderscore__ @ParkerMolloy @2sunsky @ashleyfeinberg Seems to be glitch where tweet to which I r… https://t.co/Dy6ZQDOsVp,2024,240,2264,2018-05-28
1350,1001229574057832448,Mon May 28 22:31:47 +0000 2018,@TeslaTurk Thanks 😀,851,60,911,2018-05-28
1351,1001227870054707202,Mon May 28 22:25:00 +0000 2018,@arieleax @utkuspace 2020,949,183,1132,2018-05-28
1352,1001223333646499841,Mon May 28 22:06:59 +0000 2018,@utkuspace Superchargers will ultimately cover the entire region,4755,187,4942,2018-05-28
1353,1000951606009974784,Mon May 28 04:07:14 +0000 2018,@oneunderscore__ @joshuatopolsky @ParkerMolloy @2sunsky @ashleyfeinberg Pointing out to aspiring journo &amp; Rodin spo… https://t.co/daxlsg6wLx,5471,720,6191,2018-05-28
1354,1000929806991540225,Mon May 28 02:40:37 +0000 2018,@minliangtan @taglia Thanks for offering to help. I will check with my team.,918,31,949,2018-05-28
1355,1000560807334133762,Sun May 27 02:14:20 +0000 2018,@PassionPlanet1 @oneunderscore__ @ParkerMolloy @2sunsky @ashleyfeinberg You’re right. These guys can buzzkill thems… https://t.co/0vDNJrFTQZ,1409,65,1474,2018-05-27
1356,1000560049389907969,Sun May 27 02:11:19 +0000 2018,@joshuatopolsky @oneunderscore__ @ParkerMolloy @2sunsky @ashleyfeinberg Who do you think *owns* the press? Hello.,16122,4948,21070,2018-05-27
1357,1000557306600304640,Sun May 27 02:00:26 +0000 2018,RT @TheRealStanLee: I agree with @elonmusk that the media should be held accountable to tell the truth. Many reporters are honost but Fake…,0,18458,18458,2018-05-27
1358,1000557142863036416,Sun May 27 01:59:46 +0000 2018,@oneunderscore__ @ParkerMolloy @2sunsky @ashleyfeinberg You’re missing the point &amp; living in a bubble of self-right… https://t.co/XZEKBOcPYc,12878,2199,15077,2018-05-27
1359,1000554991457779712,Sun May 27 01:51:14 +0000 2018,"@oneunderscore__ @ParkerMolloy @2sunsky @ashleyfeinberg You’re welcome to come by SpaceX, but please stop assuming… https://t.co/81pBRlWkq4",6053,433,6486,2018-05-27
1360,1000554252329078785,Sun May 27 01:48:17 +0000 2018,@oneunderscore__ @ParkerMolloy @2sunsky @ashleyfeinberg You really think I haven’t spent time in a newsroom? I’ve s… https://t.co/eR5VyJM7ra,4025,162,4187,2018-05-27
1361,1000552825145901057,Sun May 27 01:42:37 +0000 2018,"@ParkerMolloy @2sunsky @oneunderscore__ @ashleyfeinberg Sadly, it had better critical analysis than most non-cult media",4423,201,4624,2018-05-27
1362,1000551718088622080,Sun May 27 01:38:13 +0000 2018,"@RBryant2012 Yup, deleted",425,8,433,2018-05-27
1363,1000548454127452161,Sun May 27 01:25:15 +0000 2018,@MacTechGenius @DMC_Ryan @ConsumerReports ? It should,488,7,495,2018-05-27
1364,1000548306609565696,Sun May 27 01:24:40 +0000 2018,"@davinalexmma @DMC_Ryan No, but dual motors mean increased regen braking &amp; will ride tire traction limit. You won’t… https://t.co/nHNwhrD9Sn",676,22,698,2018-05-27
1365,1000547552234635265,Sun May 27 01:21:40 +0000 2018,"@DMC_Ryan Also, firmware fix for upgraded brake performance on standard Model 3 started rolling out yesterday. Shou… https://t.co/IQ6tCA9FeR",3236,304,3540,2018-05-27
1366,1000546468250308608,Sun May 27 01:17:21 +0000 2018,"@DMC_Ryan Yes, Model 3 Performance will have red calipers &amp; sport level brakes",1053,47,1100,2018-05-27
1367,1000544451620618240,Sun May 27 01:09:21 +0000 2018,@mike_marchioni Keyword “future” 🤣,483,13,496,2018-05-27
1368,1000543697224663040,Sun May 27 01:06:21 +0000 2018,@dfsullivan ♥️🖤🚀🎶👻🐇🧚‍♀️💫,799,58,857,2018-05-27
1369,1000542238051463168,Sun May 27 01:00:33 +0000 2018,"😃
https://t.co/9kUYHCCaRN",9356,822,10178,2018-05-27
1370,1000531933418242048,Sun May 27 00:19:36 +0000 2018,@SmileSimplify @nitantbhartia @ninoles @medickinson @thephysicsgirl Will do another rev before final design,493,18,511,2018-05-27
1371,1000526288522637312,Sat May 26 23:57:10 +0000 2018,@AJemaineClement I was,948,16,964,2018-05-26
1372,1000521443036180480,Sat May 26 23:37:55 +0000 2018,@ali01 @KTmBoyle @washingtonpost @JohnCarreyrou @decentralion That’s what I had in mind,467,14,481,2018-05-26
1373,1000520015014055936,Sat May 26 23:32:14 +0000 2018,@AntVenom @BoredElonMusk Sometimes even I think we’re the same person!,4406,187,4593,2018-05-26
1374,1000519587144728576,Sat May 26 23:30:32 +0000 2018,RT @BoredElonMusk: It’s never been harder to be a parody account.,0,3771,3771,2018-05-26
1375,1000515327506104323,Sat May 26 23:13:37 +0000 2018,@omcintyre @CrampedEyes @SpaceX @Tesla @upulie Nanotech *is* bs imo. When you take something that has nothing to do… https://t.co/PlXBsel9d9,734,34,768,2018-05-26
1376,1000509888534007809,Sat May 26 22:52:00 +0000 2018,"@CalebHarmon5 About to ship. @BoringCompany holding flamethrower pickup parties in a week or so, then deliveries be… https://t.co/QjeaLYNp87",450,33,483,2018-05-26
1377,1000508124980113409,Sat May 26 22:45:00 +0000 2018,@DriverX_ It’s not,532,17,549,2018-05-26
1378,1000507835787046912,Sat May 26 22:43:51 +0000 2018,@Br1__Rodriguez That’s a great song!,861,16,877,2018-05-26
1379,1000506074397523969,Sat May 26 22:36:51 +0000 2018,"Sometimes … when I have hurt feelings, I play this song …
https://t.co/QK6cECmxsS",15734,1771,17505,2018-05-26
1380,1000503790070517760,Sat May 26 22:27:46 +0000 2018,"@sjanus_pl @iloveshw No, that’s the other guy @BoredElonMusk",896,32,928,2018-05-26
1381,1000503475321516032,Sat May 26 22:26:31 +0000 2018,@firefire100 @rjcc So true 😢,565,38,603,2018-05-26
1382,1000503343007989761,Sat May 26 22:26:00 +0000 2018,@rjcc Because Twitter is fun,33960,2513,36473,2018-05-26
1383,1000502390313832448,Sat May 26 22:22:12 +0000 2018,@MDMGeek @theknifemedia USAToday FTW!,1215,50,1265,2018-05-26
1384,1000501132530139136,Sat May 26 22:17:13 +0000 2018,@iloveshw Dank is wack unless you’re on weed,1106,214,1320,2018-05-26
1385,1000498043320320001,Sat May 26 22:04:56 +0000 2018,"@petehague @ceciliakang Exactly. And NYT could have anyone post an Op Ed. Why, of all people, are they choosing to… https://t.co/Xa1pHQaaik",464,24,488,2018-05-26
1386,1000496388147314688,Sat May 26 21:58:21 +0000 2018,But femtotech is the future … https://t.co/NODkOer8oS,12785,1051,13836,2018-05-26
1387,1000492833675997184,Sat May 26 21:44:14 +0000 2018,Nanotech is so 2008. Picotech is 1000 times better.,44834,5524,50358,2018-05-26
1388,1000474267161513984,Sat May 26 20:30:27 +0000 2018,"Yeah, that’s exactly right. But after suggesting public critique, I was stunned to see the level of contempt many i… https://t.co/9nkuw1nyDi",16842,2388,19230,2018-05-26
1389,1000464215440703488,Sat May 26 19:50:31 +0000 2018,@dimas_______ @AlexCJoachim @RitNagar @jbinero @hubertlepicki @Jason @nytimes @BretStephensNYT The arguments journo… https://t.co/dkM55yZk1H,1159,220,1379,2018-05-26
1390,1000461272737959936,Sat May 26 19:38:49 +0000 2018,Well said. NYT journo is outraged that “dumb” public wd dare critique him while attacking me for being sensitive to… https://t.co/CJxqSGmK7h,12322,1430,13752,2018-05-26
1391,1000456410944061440,Sat May 26 19:19:30 +0000 2018,@TKhopshanosov @SaxMike71 @ebol94 @teslainventory @Tesla A Tesla has a usable reserve of 5 to 15 miles range even a… https://t.co/3gXVlYAtJK,576,42,618,2018-05-26
1392,1000453321121923072,Sat May 26 19:07:13 +0000 2018,@nitantbhartia @ninoles @medickinson @thephysicsgirl Pretty good. TinTin A &amp; B are both closing the link to ground… https://t.co/xUAXTXxhpU,1091,124,1215,2018-05-26
1393,1000452345166086144,Sat May 26 19:03:21 +0000 2018,"@ssBlueStockings @ninoles @medickinson @thephysicsgirl It’s cool for kids &amp; if used in a fun way, but if you called… https://t.co/3K386Mno7H",409,9,418,2018-05-26
1394,1000450270399119361,Sat May 26 18:55:06 +0000 2018,"RT @hubertlepicki: @Jason @nytimes @BretStephensNYT @nytimes So @elonmusk picks a fight with journalists, citing their lack of integrity an…",0,1270,1270,2018-05-26
1395,1000449499221803009,Sat May 26 18:52:02 +0000 2018,@JuBeBallin I just sent a note to Tesla service to take care of your car right away &amp; our HVAC engineering lead to fix root cause,502,17,519,2018-05-26
1396,1000448564240138240,Sat May 26 18:48:19 +0000 2018,@Pocketsdog @omcintyre @CrampedEyes @SpaceX @Tesla Does the psych ward know you smuggled in a mobile phone?,2955,475,3430,2018-05-26
1397,1000448110085079040,Sat May 26 18:46:31 +0000 2018,@aquastellaris @Pocketsdog @omcintyre @CrampedEyes @SpaceX @Tesla The pain will end,653,124,777,2018-05-26
1398,1000447759143464960,Sat May 26 18:45:07 +0000 2018,"Wow, amazing Tesla hypermile drive happening https://t.co/jJWufZ98C9",10181,796,10977,2018-05-26
1399,1000447314748588033,Sat May 26 18:43:21 +0000 2018,@tedhu @omcintyre @CrampedEyes @SpaceX @Tesla Gwynne has been prez of SpaceX for 10 years &amp; well-deserved https://t.co/XL581njDHP,595,40,635,2018-05-26
1400,1000446346640244736,Sat May 26 18:39:31 +0000 2018,"@Pocketsdog @omcintyre @CrampedEyes @SpaceX @Tesla Stop trying to charm me. It won’t work. Ok, maybe a little 😊 Are… https://t.co/156V8mPofW",798,29,827,2018-05-26
1401,1000444616536031232,Sat May 26 18:32:38 +0000 2018,"@ninoles @medickinson @thephysicsgirl Using “rocket science” non-ironically in a bio is never a good sign, especially if you work on 🚀🔬",472,15,487,2018-05-26
1402,1000435924369522689,Sat May 26 17:58:06 +0000 2018,@omcintyre @CrampedEyes @SpaceX @Tesla What are you talking about? You’re being incredibly rude &amp; nonsensical.,803,23,826,2018-05-26
1403,1000434638991454208,Sat May 26 17:52:59 +0000 2018,"@ishanspatil @kNewsSpace Wow, haven’t watched that video in ages. When we made that, no one in the space industry t… https://t.co/TsRN3stA1K",417,15,432,2018-05-26
1404,1000431923502530560,Sat May 26 17:42:12 +0000 2018,"@Jessicalessin Generally higher quality reporting, especially if not under pressure to publish fast. Consumer Repor… https://t.co/WaqsqdIKWG",1829,90,1919,2018-05-26
1405,1000332404618227712,Sat May 26 11:06:45 +0000 2018,Can’t believe someone leaked this schematic of the Tesla production system!! https://t.co/ylAX3uKTI1,47500,4323,51823,2018-05-26
1406,1000258709950431234,Sat May 26 06:13:55 +0000 2018,"@taglia We tried, but Singapore govt is not supportive of electric vehicles",1235,274,1509,2018-05-26
1407,1000208369959845889,Sat May 26 02:53:53 +0000 2018,@acid0 Tesla will start extending the Supercharger network to South America around end of next year,1051,100,1151,2018-05-26
1408,1000207973430394880,Sat May 26 02:52:18 +0000 2018,@soukyjer Prob end of next year,673,25,698,2018-05-26
1409,1000207725983293441,Sat May 26 02:51:19 +0000 2018,"@Tidnisher Good point, we will add that to the construction plan",1637,46,1683,2018-05-26
1410,1000204113953439744,Sat May 26 02:36:58 +0000 2018,"Global map of Tesla Superchargers, including those coming soon https://t.co/Ld5FQgCSs1",24566,2882,27448,2018-05-26
1411,1000164497217081344,Fri May 25 23:59:32 +0000 2018,"@WorldAndScience Earth’s rotation is slowly, slowly, slowly getting slower",16646,1106,17752,2018-05-25
1412,1000151412033155073,Fri May 25 23:07:33 +0000 2018,@compoundchem You’re making my point. It’s tragic that there’s a national nano day. I wish I didn’t know that.,1746,59,1805,2018-05-25
1413,1000150631666069506,Fri May 25 23:04:27 +0000 2018,@EVNewsDaily @Tesla All four. Zone 3 throughput was solved a couple of weeks ago.,664,33,697,2018-05-25
1414,1000148499227467778,Fri May 25 22:55:58 +0000 2018,RT @tslajms: @elonmusk @Tesla Thank you so much for this life changing car. The wife an I flew to Vegas to pickup our #Model3 and drove it…,0,649,649,2018-05-25
1415,1000148304016105472,Fri May 25 22:55:12 +0000 2018,@ElecVehicleGuy @EVNewsDaily @Tesla Model 3 was designed for min engineering &amp; tooling change for RHD. Note left/ri… https://t.co/QhFaj2d0Ue,568,44,612,2018-05-25
1416,1000143728500269057,Fri May 25 22:37:01 +0000 2018,@EVNewsDaily @Tesla This is the new production line for battery module Zone 4. Will play a key role in getting from… https://t.co/M9V81eXEBS,3134,178,3312,2018-05-25
1417,1000130445856595968,Fri May 25 21:44:14 +0000 2018,@erinbiba I have never attacked science. Definitely attacked misleading journalism like yours though.,10670,1593,12263,2018-05-25
1418,1000102229376839680,Fri May 25 19:52:07 +0000 2018,RT @MattLevinson: Thank you @elonmusk and @tesla for by FAR the best consumer product I have ever used. Day one is a 6 hour road trip to ca…,0,931,931,2018-05-25
1419,1000098080857907200,Fri May 25 19:35:38 +0000 2018,"@chick_in_kiev @evepeyser @broderick Pravda was incorporated a year ago. Also, Tesla factory safety has improved ev… https://t.co/Bwdow67lCO",1265,50,1315,2018-05-25
1420,1000085435668819968,Fri May 25 18:45:23 +0000 2018,@nilgirian Worth a shot,477,15,492,2018-05-25
1421,1000084944704569344,Fri May 25 18:43:26 +0000 2018,@evepeyser @broderick Of course! (Prav)Duh. It is named after the most pernicious propaganda machine in history spe… https://t.co/P1muRb2IB3,1913,105,2018,2018-05-25
1422,1000082615276191744,Fri May 25 18:34:10 +0000 2018,"@evepeyser @broderick This is going to help journalism, not harm it. Please be so kind as to hold your fire until you actually see it.",1840,72,1912,2018-05-25
1423,1000080833678528512,Fri May 25 18:27:06 +0000 2018,"Problem solved, was able to buy https://t.co/ivSUwPqsDT! Game on …",37834,4407,42241,2018-05-25
1424,1000079983543382016,Fri May 25 18:23:43 +0000 2018,"@kot_kotushkin I know, I know. Russia seriously didn’t correct me on this!",497,14,511,2018-05-25
1425,1000079980611624960,Fri May 25 18:23:42 +0000 2018,"@broderick Something needs to be done to reward consistent, high quality journalism. Some in media are absurdly ind… https://t.co/sIJJtkJOaB",2118,122,2240,2018-05-25
1426,1000079978220802049,Fri May 25 18:23:42 +0000 2018,"Turns out https://t.co/S5kmNfnih8 is actually owned by Ukraine. For some reason, Russia didn’t bother to correct me …",8679,888,9567,2018-05-25
1427,1000079975150596096,Fri May 25 18:23:41 +0000 2018,"@designcollector For some reason, Russia didn’t bother to correct me …",723,18,741,2018-05-25
1428,1000072092769964033,Fri May 25 17:52:22 +0000 2018,"Tried to buy https://t.co/S5kmNfnih8, but Russia said no. Turns out they already use it.",13088,1648,14736,2018-05-25
1429,999848310344044544,Fri May 25 03:03:08 +0000 2018,@DavisTravis9830 @amywestervelt @Billsocalif @RMac18 @weinbergersa Definitely did not. I’ve been through many press… https://t.co/quPQs6TJxA,1783,151,1934,2018-05-25
1430,999845637385404416,Fri May 25 02:52:30 +0000 2018,@amywestervelt @Billsocalif @RMac18 @weinbergersa I’ve just had it with sanctimonious journalists who appoint thems… https://t.co/u4gsbQAGeC,5081,1162,6243,2018-05-25
1431,999841559846633473,Fri May 25 02:36:18 +0000 2018,@spacecom @amywestervelt @weinbergersa The Tesla facility is open plan &amp; we’re not going to erect walls everywhere… https://t.co/VfQBEuBNep,1079,59,1138,2018-05-25
1432,999809802988482560,Fri May 25 00:30:07 +0000 2018,@ObviousParadox @medickinson @thephysicsgirl No,440,11,451,2018-05-25
1433,999808730106445824,Fri May 25 00:25:51 +0000 2018,@medickinson @thephysicsgirl Nano applies to everything &amp; therefore means nothing. Definitely indicates bs. Sorry. https://t.co/WQp8j9YkeJ,3946,205,4151,2018-05-25
1434,999797465787191297,Thu May 24 23:41:05 +0000 2018,"@amywestervelt @weinbergersa Yes, because Tesla has the most advanced battery manufacturing technology in the world… https://t.co/Pxcgp1QlKk",3288,197,3485,2018-05-24
1435,999796653560283136,Thu May 24 23:37:52 +0000 2018,"@weinbergersa Wow, you’re ignorant. Don’t remember you, but disclosing classified US missile technology to hostile… https://t.co/T5mvtMk947",46772,4601,51373,2018-05-24
1436,999760374529327104,Thu May 24 21:13:42 +0000 2018,RT @tecnocato: TODAY our solar roof generated 68 kWh. My house consumption was 25.8 kWh giving us a surplus of 42 kWh of energy. That's eno…,0,3667,3667,2018-05-24
1437,999619147305660416,Thu May 24 11:52:31 +0000 2018,@PolitiFact @PayPal @Poynter Done,1388,55,1443,2018-05-24
1438,999597963482574848,Thu May 24 10:28:20 +0000 2018,@jennineak Have a confirmed real name identity section &amp; an unconfirmed identity section. Latter with subscore that… https://t.co/wzXxMxo01w,897,34,931,2018-05-24
1439,999594838973542400,Thu May 24 10:15:55 +0000 2018,@DX_1 Be careful what you wish for https://t.co/3mSj15UeIw,12347,1146,13493,2018-05-24
1440,999591624521940993,Thu May 24 10:03:09 +0000 2018,"Amazingly, the “media is awesome” vote is declining, despite hundreds of articles attacking this very poll🤔",31734,2439,34173,2018-05-24
1441,999589943000358913,Thu May 24 09:56:28 +0000 2018,My point exactly https://t.co/PQ7PFqeC3X,12173,992,13165,2018-05-24
1442,999579712484790272,Thu May 24 09:15:49 +0000 2018,"@upulie Ahem, you have “nano” in your bio. That is 100% synonymous with bs.",1400,98,1498,2018-05-24
1443,999570680210276352,Thu May 24 08:39:55 +0000 2018,@donny0m Reddit is great,1382,170,1552,2018-05-24
1444,999568719146725377,Thu May 24 08:32:08 +0000 2018,"Come on media, you can do it! Get more people to vote for you. You are literally the media.",32057,2362,34419,2018-05-24
1445,999560417637580800,Thu May 24 07:59:09 +0000 2018,@PassionPlanet1 @supernovaslight @lexiheft @dancow @tedhu @chadgowens @scottwww @JessicaHuseman Exactly. The point… https://t.co/onVBFdXO99,807,73,880,2018-05-24
1446,999524442211418114,Thu May 24 05:36:11 +0000 2018,@lexiheft @dancow @tedhu @chadgowens @scottwww @JessicaHuseman Why are certain journalists (editors especially) so… https://t.co/ftN61bQLzS,3811,981,4792,2018-05-24
1447,999520453071855616,Thu May 24 05:20:20 +0000 2018,@dancow @tedhu @chadgowens @scottwww @JessicaHuseman I did to any who asked,777,16,793,2018-05-24
1448,999517376772165632,Thu May 24 05:08:07 +0000 2018,@dancow @tedhu @chadgowens @scottwww @JessicaHuseman That was obvious from a mile away. I tried to use their produc… https://t.co/ayvBoxkiyp,786,28,814,2018-05-24
1449,999515261479731200,Thu May 24 04:59:43 +0000 2018,"@DMC_Ryan @teslanomicsco @Tesla Maybe after you get your Model 3, we can talk about what you like &amp; what needs to be improved",1912,40,1952,2018-05-24
1450,999513492825620481,Thu May 24 04:52:41 +0000 2018,@DMC_Ryan @teslanomicsco But consider it real. We could unveil Model Y anytime from late this year to mid next year… https://t.co/AuzYxyEAzf,2178,87,2265,2018-05-24
1451,999513049470922752,Thu May 24 04:50:55 +0000 2018,"@DMC_Ryan @teslanomicsco I just made that up, because the Ides of March sounded good",2787,63,2850,2018-05-24
1452,999512438142787585,Thu May 24 04:48:29 +0000 2018,@eugenelee3 @karaswisher @Jason Gasoline or diesel?,353,6,359,2018-05-24
1453,999511881160130565,Thu May 24 04:46:17 +0000 2018,@karaswisher @Jason What car do you drive?,722,30,752,2018-05-24
1454,999502403207544832,Thu May 24 04:08:37 +0000 2018,@teslanomicsco March 15,2318,87,2405,2018-05-24
1455,999500971045629952,Thu May 24 04:02:55 +0000 2018,@mainhoonmaun The media,984,44,1028,2018-05-24
1456,999466717112745985,Thu May 24 01:46:49 +0000 2018,"@karaswisher Hi Kara! I’m open to it. Right now, I’m cranking super hard at the Tesla factory, so it depends on how… https://t.co/KaPyhPhEmD",5544,269,5813,2018-05-24
1457,999465692859527168,Thu May 24 01:42:45 +0000 2018,Maybe the media credibility rating site should be called “You’re Right!”  I do actually own https://t.co/1JqqCF9inA… https://t.co/PhWl5RvjTQ,20879,1755,22634,2018-05-24
1458,999462420790755334,Thu May 24 01:29:44 +0000 2018,@TruthForceSteem @kali0x2a Definitely,462,13,475,2018-05-24
1459,999451883092652032,Thu May 24 00:47:52 +0000 2018,"@MrNobre There no good car emojis. I mean seriously, what the heck are these 🚗 🚙 and this is the best one 🚘",4965,373,5338,2018-05-24
1460,999451013391179776,Thu May 24 00:44:25 +0000 2018,@CryptoAlesio Yo,3790,145,3935,2018-05-24
1461,999450781437706241,Thu May 24 00:43:29 +0000 2018,@benschwartzy That’s the basic idea,1165,23,1188,2018-05-24
1462,999450636075778049,Thu May 24 00:42:55 +0000 2018,"For some reason, this is the best I’ve felt in a while. Hope you’re feeling good too 🚀♥️🌏",149599,17390,166989,2018-05-24
1463,999448547513614336,Thu May 24 00:34:37 +0000 2018,"@PolitiFact I just tried to donate, but you don’t accept PayPal. Lmk when you do.",6255,255,6510,2018-05-24
1464,999424264880058368,Wed May 23 22:58:07 +0000 2018,"@adnroy Um, you just tweeted about this, so obv you do",15894,693,16587,2018-05-23
1465,999424262925533184,Wed May 23 22:58:07 +0000 2018,@southtopia Thank you! I thought it was so obvious …,2264,62,2326,2018-05-23
1466,999415738967277568,Wed May 23 22:24:15 +0000 2018,@AltWouss @jackallisonLOL @ParkerMolloy Exactly. UAW does not have individual stock ownership as part of the compen… https://t.co/VGCFwxRU1T,910,45,955,2018-05-23
1467,999398212162105344,Wed May 23 21:14:36 +0000 2018,"@PolitiFact Yeah, I think you do great work",2732,74,2806,2018-05-23
1468,999389139551248384,Wed May 23 20:38:33 +0000 2018,"If you’re in media &amp; don’t want Pravda to exist, write an article telling your readers to vote against it …",26847,2326,29173,2018-05-23
1469,999385597771853824,Wed May 23 20:24:28 +0000 2018,@meharris 🤗,10123,235,10358,2018-05-23
1470,999385249720057856,Wed May 23 20:23:05 +0000 2018,@ParkerMolloy I’ve never stopped a union vote nor removed a union. UAW abandoned this factory. Tesla arrived &amp; gave… https://t.co/Wbqm5gmhuU,2559,211,2770,2018-05-23
1471,999382070848770048,Wed May 23 20:10:27 +0000 2018,@meharris Of course,718,26,744,2018-05-23
1472,999378223661137920,Wed May 23 19:55:10 +0000 2018,@scottwww @JessicaHuseman It is strange that big auto companies literally have thousands more factory injuries than… https://t.co/xJ6skM7bzd,3217,334,3551,2018-05-23
1473,999376607662952448,Wed May 23 19:48:45 +0000 2018,"@JessicaHuseman @reveal No, they’re just some rich kids in Berkeley who took their political science prof too seriously",9071,923,9994,2018-05-23
1474,999375777882750976,Wed May 23 19:45:27 +0000 2018,@iShashankBhatia Will do,626,16,642,2018-05-23
1475,999374720368689153,Wed May 23 19:41:15 +0000 2018,Create a media credibility rating site (that also flags propaganda botnets),40732,13785,54517,2018-05-23
1476,999371548053000193,Wed May 23 19:28:39 +0000 2018,@scotch_io That’s why editors are included too,1079,28,1107,2018-05-23
1477,999370318383742976,Wed May 23 19:23:45 +0000 2018,@SophieWarnes We don’t. The media is reporting someone else saying that Tesla advertised. It is untrue.,2441,96,2537,2018-05-23
1478,999369921103413248,Wed May 23 19:22:11 +0000 2018,"RT @elonmusk: @Virtualanom Not only needs to be botproof, but seek &amp; unmask anyone operating a disinformation bot army",0,1153,1153,2018-05-23
1479,999369623484039168,Wed May 23 19:21:00 +0000 2018,"Even if some of the public doesn’t care about the credibility score, the journalists, editors &amp; publications will.… https://t.co/BAYfSMb7M1",49021,4752,53773,2018-05-23
1480,999369022280843264,Wed May 23 19:18:36 +0000 2018,@DetroitVictoria Enough of the public does care about the truth. I have faith in the people.,20693,1362,22055,2018-05-23
1481,999368671972622336,Wed May 23 19:17:13 +0000 2018,@AntVenom Maybe some good people from those orgs who would join,5229,132,5361,2018-05-23
1482,999368393420488704,Wed May 23 19:16:07 +0000 2018,"@Virtualanom Not only needs to be botproof, but seek &amp; unmask anyone operating a disinformation bot army",15813,1153,16966,2018-05-23
1483,999367998078042114,Wed May 23 19:14:32 +0000 2018,@sakiwebo Exactly,1150,45,1195,2018-05-23
1484,999367582271422464,Wed May 23 19:12:53 +0000 2018,Going to create a site where the public can rate the core truth of any article &amp; track the credibility score over t… https://t.co/r30AlZA598,247790,51275,299065,2018-05-23
1485,999365829761249280,Wed May 23 19:05:55 +0000 2018,@dancow @WSJ An exception that proves the rule,1322,32,1354,2018-05-23
1486,999365292684861441,Wed May 23 19:03:47 +0000 2018,"@CodyBrown Uh, this is Twitter. How many characters do you want?",4474,148,4622,2018-05-23
1487,999364333674024960,Wed May 23 18:59:59 +0000 2018,Problem is journos are under constant pressure to get max clicks &amp; earn advertising dollars or get fired. Tricky si… https://t.co/6ZnLOprDhn,45435,6525,51960,2018-05-23
1488,999363031996948480,Wed May 23 18:54:48 +0000 2018,@teddymonacelli The media has earned this mistrust. But maybe there is a solution.,7554,706,8260,2018-05-23
1489,999361510915768320,Wed May 23 18:48:46 +0000 2018,@jaspar Oh hey another sanctimonious media person who thinks he’s above criticism. Try being truthful &amp; the public will believe you again.,5052,480,5532,2018-05-23
1490,999359660854362112,Wed May 23 18:41:25 +0000 2018,"RT @elonmusk: @andyjayhawk Thought you’d say that. Anytime anyone criticizes the media, the media shrieks “You’re just like Trump!” Why do…",0,20338,20338,2018-05-23
1491,999357298861486080,Wed May 23 18:32:01 +0000 2018,"@andyjayhawk Thought you’d say that. Anytime anyone criticizes the media, the media shrieks “You’re just like Trump… https://t.co/Nqzvt1leJ2",75505,20338,95843,2018-05-23
1492,999355619390865408,Wed May 23 18:25:21 +0000 2018,"The holier-than-thou hypocrisy of big media companies who lay claim to the truth, but publish only enough to sugarc… https://t.co/4AIyHgnkKD",51885,12766,64651,2018-05-23
1493,999234369112850432,Wed May 23 10:23:33 +0000 2018,"@girllovesbread @ZainRaz4 @mashable This will sound super obvious, but Genesis &amp; Oblivion",765,42,807,2018-05-23
1494,999233903456997376,Wed May 23 10:21:42 +0000 2018,@JohnBirmingham @mashable I am not cool,1468,142,1610,2018-05-23
1495,999232361236590592,Wed May 23 10:15:34 +0000 2018,@ZainRaz4 @mashable The one about to come out called So Heavy i fell through the earth,876,31,907,2018-05-23
1496,999229479514853379,Wed May 23 10:04:07 +0000 2018,"@mashable Was sad to see G getting tons of undeserved flak because of me, so I’m glad there’s some good too ♥️🎼🐇. Her music is incredible.",13051,492,13543,2018-05-23
1497,999196107505745920,Wed May 23 07:51:30 +0000 2018,"RT @ElectrekCo: Tesla Model 3 sales beat BMW 3-Series and Mercedes C-Class during first quarter in California, says report https://t.co/k0r…",0,1220,1220,2018-05-23
1498,999169329353506818,Wed May 23 06:05:06 +0000 2018,RT @physorg_com: Two sportscar-sized satellites in orbit to measure Earth's water https://t.co/7qiqy4SEVD,0,548,548,2018-05-23
1499,999161021657837568,Wed May 23 05:32:05 +0000 2018,@bevvscott Thanks. Not super fun right now 😔,593,33,626,2018-05-23
1500,999155581012230144,Wed May 23 05:10:28 +0000 2018,@kulpability @DeusEx Busted 👻,1576,23,1599,2018-05-23
1501,999154641085448192,Wed May 23 05:06:44 +0000 2018,@CateLuvsLondon @Aceinmysleeve1 @ericbrownzzz @dmatkins137 @ShayneRarma @NASA None of those criteria are certain by… https://t.co/tiVo5TjnBC,471,19,490,2018-05-23
1502,999152289246920704,Wed May 23 04:57:23 +0000 2018,RT @SpaceX: More photos from today’s Falcon 9 launch → https://t.co/095WHX44BX https://t.co/K2QlUnwKcJ,0,4769,4769,2018-05-23
1503,999149447975133184,Wed May 23 04:46:06 +0000 2018,"@Aceinmysleeve1 @ericbrownzzz @dmatkins137 @ShayneRarma @NASA Troll dead giveaways: not using real names, obv fake… https://t.co/WsurW07jB8",531,26,557,2018-05-23
1504,999062738402881537,Tue May 22 23:01:33 +0000 2018,@AustinOnSocial Great idea!,4328,84,4412,2018-05-22
1505,999056596935233536,Tue May 22 22:37:08 +0000 2018,@annerajb @ericbrownzzz @dmatkins137 @ShayneRarma @NASA Will do it later this year. Too much on plate right now. Wi… https://t.co/gNFv7x8QJa,548,30,578,2018-05-22
1506,999056071489548288,Tue May 22 22:35:03 +0000 2018,@DeusEx Love original Deus Ex! That would be awesome.,3792,195,3987,2018-05-22
1507,999020811930423297,Tue May 22 20:14:57 +0000 2018,@UAW @speea @AlterViggo @juliacarriew Interesting he stops at ‘09. That’s when you drove GM &amp; Chrysler into bankrup… https://t.co/9HaDoo6A08,791,59,850,2018-05-22
1508,999010644572553216,Tue May 22 19:34:33 +0000 2018,@matthunter Just order your car with the James Bond option package. It’s an off-menu item for those in the know 😉,9973,490,10463,2018-05-22
1509,999010167793504256,Tue May 22 19:32:39 +0000 2018,"@ericbrownzzz @dmatkins137 @ShayneRarma @NASA But ya know what, let’s test that theory. Maybe we do want UAW back,… https://t.co/T8SK1RyUhl",696,43,739,2018-05-22
1510,998996857979256832,Tue May 22 18:39:46 +0000 2018,"RT @jodigralnick: ICYMI: here’s another 5 minutes of @MorganLBrennan exclusive interview with @SpaceX president &amp; COO Gwynne Shotwell, talk…",0,322,322,2018-05-22
1511,998996397570441216,Tue May 22 18:37:56 +0000 2018,"@speea @AlterViggo @juliacarriew In theory true, but not how UAW behaved. They drove GM &amp; Chrysler to bankruptcy &amp;… https://t.co/ykp2XUCTgT",655,60,715,2018-05-22
1512,998988641702526977,Tue May 22 18:07:07 +0000 2018,"We’re going to include some fun games as hidden Easter eggs in Tesla S, X &amp; 3. What do you think would be most fun… https://t.co/N5DOkBfmTI",42735,2852,45587,2018-05-22
1513,998988091556704256,Tue May 22 18:04:55 +0000 2018,@OldManLink Good point,350,15,365,2018-05-22
1514,998987396870950912,Tue May 22 18:02:10 +0000 2018,"@ericbrownzzz @dmatkins137 @ShayneRarma @NASA No, UAW does that. They want divisiveness &amp; enforcement of 2 class “l… https://t.co/LurKO8OEJR",1071,86,1157,2018-05-22
1515,998984720783323136,Tue May 22 17:51:32 +0000 2018,"@mikeyfranklin @dmatkins137 @ShayneRarma @NASA More “Reveal” bs. Tesla is overseen by Cal/OSHA, most stringent labo… https://t.co/DmWc0HtRWF",619,45,664,2018-05-22
1516,998981687743741952,Tue May 22 17:39:29 +0000 2018,@SarahKnuckey @JeffBezos @Oprah @kobebryant @richardbranson @shanesmith30 No problem,416,13,429,2018-05-22
1517,998980096181628929,Tue May 22 17:33:09 +0000 2018,"@SarahKnuckey @JeffBezos @Oprah @kobebryant @richardbranson @shanesmith30 They are incorrect. We never met, nor hav… https://t.co/x1jtfYrPRT",497,15,512,2018-05-22
1518,998953706673487873,Tue May 22 15:48:17 +0000 2018,"@DMC_Ryan @loganthefirst Thanks again, have conveyed your words to the Tesla team, who have been working crazy hard. Really energizing!",638,27,665,2018-05-22
1519,998950122225455105,Tue May 22 15:34:03 +0000 2018,@SarahKnuckey @JeffBezos @Oprah @kobebryant @richardbranson @shanesmith30 I didn’t meet with him,2636,84,2720,2018-05-22
1520,998797622461710337,Tue May 22 05:28:04 +0000 2018,@dinisguarda I definitely don’t do this 5 minute thing. Need to have long uninterrupted times to think. Can’t be creative otherwise.,10325,905,11230,2018-05-22
1521,998786412970369024,Tue May 22 04:43:32 +0000 2018,Just wanted to say thanks to all Tesla supporters. I damn well love you.,149590,9801,159391,2018-05-22
1522,998782142556467201,Tue May 22 04:26:33 +0000 2018,@rrosenbl @ElectrekCo @FredericLambert @Tesla Have been meaning to get around to talking to him. Some of his critic… https://t.co/IBFSiCGIPl,688,36,724,2018-05-22
1523,998780707164995585,Tue May 22 04:20:51 +0000 2018,"@DMC_Ryan @loganthefirst Thanks Ryan. Critical feedback after you get the car would be much appreciated, no matter how nuanced.",737,27,764,2018-05-22
1524,998779781230379014,Tue May 22 04:17:10 +0000 2018,"@samuelrogg @ElectrekCo @FredericLambert To be clear, all Model 3 cars, incl early production will have same great… https://t.co/d7RNErtNAj",651,36,687,2018-05-22
1525,998778751767871488,Tue May 22 04:13:05 +0000 2018,@rrosenbl @ElectrekCo @FredericLambert ABS calibration algorithm,692,31,723,2018-05-22
1526,998778081492926465,Tue May 22 04:10:25 +0000 2018,"@ElectrekCo @FredericLambert Also, Consumer Reports has an early production car. Model 3 now has improved ride comf… https://t.co/a9oYlRosxK",1307,91,1398,2018-05-22
1527,998777288559755264,Tue May 22 04:07:16 +0000 2018,@ElectrekCo @FredericLambert Looks like this can be fixed with a firmware update. Will be rolling that out in a few… https://t.co/EC7VTkOScm,5584,367,5951,2018-05-22
1528,998765102248542208,Tue May 22 03:18:51 +0000 2018,"@camgfrost @DMC_Ryan @loganthefirst Stop, you’re making me blush ☺️",573,29,602,2018-05-22
1529,998762156752449537,Tue May 22 03:07:08 +0000 2018,"@DMC_Ryan @loganthefirst Also, not promising anything, but we *might* be able to increase Model 3 Performance power output a little",684,41,725,2018-05-22
1530,998761472292352000,Tue May 22 03:04:25 +0000 2018,@DMC_Ryan @loganthefirst Complexity is the devil. Words can’t express how hard we are working on the Model 3 produc… https://t.co/tjG07ZR15h,680,39,719,2018-05-22
1531,998739940073590784,Tue May 22 01:38:52 +0000 2018,"@teslaology @ElectrekCo @FredericLambert Good point. Yeah, we will do that for the bigger locations.",929,37,966,2018-05-22
1532,998739763543736320,Tue May 22 01:38:09 +0000 2018,"@LanceUlanoff The CR braking result is inconsistent with other reviewers, but might indicate that some Model 3’s ha… https://t.co/lvkux7HGtM",3784,165,3949,2018-05-22
1533,998738577344229377,Tue May 22 01:33:27 +0000 2018,"@ElectrekCo @FredericLambert Even if a physical upgrade is needed to existing fleet, we will make sure all Model 3’… https://t.co/KnpJrIOPcD",1634,132,1766,2018-05-22
1534,998738003668357120,Tue May 22 01:31:10 +0000 2018,@ElectrekCo @FredericLambert Very strange. Model 3 is designed to have super good stopping distance &amp; others review… https://t.co/bp91jFsU65,5421,262,5683,2018-05-22
1535,998730620464316416,Tue May 22 01:01:50 +0000 2018,"RT @jodigralnick: ALL DAY TOMORROW ON @CNBC: @MorganLBrennan has an exclusive look at @SpaceX, including a sitdown with President &amp; COO Gwy…",0,477,477,2018-05-22
1536,998673550616621056,Mon May 21 21:15:03 +0000 2018,"@reveal @dmatkins137 @ShayneRarma @NASA @Al_Letson Cool, we can do the interview at Tesla in front of the yellow ba… https://t.co/QKeZtL4NS8",1632,148,1780,2018-05-21
1537,998525148264198144,Mon May 21 11:25:21 +0000 2018,RT @nova_road: Commercial Crew astronaut Suni Williams wearing a #SpaceX spacesuit while training with a mock-up of the Crew Dragon in Hawt…,0,2102,2102,2018-05-21
1538,998460891355004928,Mon May 21 07:10:01 +0000 2018,@MrsYomaddy @dmatkins137 @ShayneRarma @NASA Gwynne’s awesome. Been SpaceX prez for 10 years. Super love working with her.,931,49,980,2018-05-21
1539,998460106579701760,Mon May 21 07:06:54 +0000 2018,@Dani21 @dmatkins137 @ShayneRarma @NASA ♥️🦄,546,42,588,2018-05-21
1540,998459709446176768,Mon May 21 07:05:19 +0000 2018,"@dmatkins137 @ShayneRarma @NASA Also, UAW did nada for job security in last recession. Dropped Fremont like a hot p… https://t.co/iJ8PNR9hW8",1532,92,1624,2018-05-21
1541,998454539941367808,Mon May 21 06:44:47 +0000 2018,@dmatkins137 @ShayneRarma @NASA Nothing stopping Tesla team at our car plant from voting union. Could do so tmrw if… https://t.co/EI77ENhl8d,1727,113,1840,2018-05-21
1542,998449970528247808,Mon May 21 06:26:37 +0000 2018,@dmatkins137 @ShayneRarma @NASA Tesla factory literally has miles of painted yellow lines &amp; tape. Report about fork… https://t.co/rhKvH0S7VX,1813,81,1894,2018-05-21
1543,998410421244542978,Mon May 21 03:49:28 +0000 2018,@maxrogo We’re working on allowing you to use your phone in car when you hear a rattle/squeak &amp; pinpoint origin by… https://t.co/nng7isXr9l,1114,76,1190,2018-05-21
1544,998409778316496896,Mon May 21 03:46:55 +0000 2018,SpaceX Crew Dragon ship in anechoic chamber for EMI testing before being sent to @NASA Plum Brook vacuum chamber https://t.co/BckUBkroLw,28741,3610,32351,2018-05-21
1545,998405757434580997,Mon May 21 03:30:56 +0000 2018,@georgechang @Tesla For sure before snowfall this year,469,20,489,2018-05-21
1546,998403872942166017,Mon May 21 03:23:27 +0000 2018,"RT @Tesla: Model X is the first and only SUV to achieve a NHTSA 5-Star safety rating in every category and subcategory, with the lowest pro…",0,12503,12503,2018-05-21
1547,998402168049848320,Mon May 21 03:16:40 +0000 2018,@trace_remick @clprenz @ivanovi_ivaylo It can tow far more than rated capacity,588,32,620,2018-05-21
1548,998401234070581248,Mon May 21 03:12:58 +0000 2018,@clprenz @ivanovi_ivaylo Exactly! Will probably unveil next gen Supercharger late summer. Major improvements all round.,821,79,900,2018-05-21
1549,998400110156550144,Mon May 21 03:08:30 +0000 2018,"@ivanovi_ivaylo With production, 1st you need achieve target rate &amp; then smooth out flow to achieve target cost. Sh… https://t.co/KjCqY9npyX",1021,118,1139,2018-05-21
1550,998372753362173952,Mon May 21 01:19:47 +0000 2018,@willardslammo @marshall5912 @buckycovington @MacTechGenius That means nothing. Literally your Mom could file for NLRB.,520,34,554,2018-05-21
1551,998372206588538880,Mon May 21 01:17:37 +0000 2018,@MacTechGenius @marshall5912 @buckycovington Exactly 🚀💫🎉! That will be really fun &amp; shed light on what’s happening.… https://t.co/1b6NQcGLwv,507,25,532,2018-05-21
1552,998370453474312192,Mon May 21 01:10:39 +0000 2018,"@marshall5912 @buckycovington @MacTechGenius Yeah, “Reveal” was carefully constructed propaganda with a name that w… https://t.co/IVUZlkqszY",474,39,513,2018-05-21
1553,998369524599504896,Mon May 21 01:06:58 +0000 2018,"@marshall5912 @buckycovington @MacTechGenius About 2% of Tesla, incl salaried &amp; hourly, union &amp; non-union were let… https://t.co/k1A7HNR2Rw",633,32,665,2018-05-21
1554,998124236542656517,Sun May 20 08:52:16 +0000 2018,@AKSINGH_S Yes,538,16,554,2018-05-20
1555,998124143685001217,Sun May 20 08:51:54 +0000 2018,@KingLutron @marshall5912 @buckycovington @MacTechGenius Exactly,428,15,443,2018-05-20
1556,998124140090376192,Sun May 20 08:51:53 +0000 2018,@marshall5912 @buckycovington @MacTechGenius They can form a union whenever they want &amp; there’s nothing I can do to… https://t.co/1cLiyCdfVv,992,45,1037,2018-05-20
1557,998091600541630464,Sun May 20 06:42:35 +0000 2018,@paulmacguyscott Upgrade to the latest S. Nothing will give you greater joy. It’s like being able to have dopamine… https://t.co/nyW9p7F40Q,1142,54,1196,2018-05-20
1558,998091052580986880,Sun May 20 06:40:25 +0000 2018,"@Josh_Soto They are correct. It’s awesome. Second best driving feel of any car in the world imo, apart from Model S… https://t.co/FVjbBbJETA",1089,47,1136,2018-05-20
1559,998090360306810880,Sun May 20 06:37:40 +0000 2018,"@JimmyRussellExe It does so constantly, but so smoothly that you can’t tell",799,23,822,2018-05-20
1560,998090184288694272,Sun May 20 06:36:58 +0000 2018,@AntVenom @zacharyj98 Depends on when you placed your initial reservation. We start delivering the dual motor Model 3 in July.,550,23,573,2018-05-20
1561,998089917065453568,Sun May 20 06:35:54 +0000 2018,"@Josh_Soto Three or four months, depending on demand level. We have enough for about 1000/week right now.",1000,35,1035,2018-05-20
1562,998089603964747776,Sun May 20 06:34:39 +0000 2018,@zacharyj98 Good idea ...,720,35,755,2018-05-20
1563,998089449400516608,Sun May 20 06:34:02 +0000 2018,@MacTechGenius That is true. Electric motors are far more reliable than combustion engines. You need an electric mo… https://t.co/Nst4zjBA7N,1637,105,1742,2018-05-20
1564,998088849636016128,Sun May 20 06:31:40 +0000 2018,Tesla dual motor means there is a motor in front &amp; a motor in rear. One is optimized for power &amp; one for range. Car… https://t.co/ciiUHjpPdl,46657,4415,51072,2018-05-20
1565,998087743530913792,Sun May 20 06:27:16 +0000 2018,Cost of normal dual motor AWD option is $5k. Range is also 310 miles. Takes 0-60mph to 4.5 sec &amp; top speed to 140 mph.,14766,1118,15884,2018-05-20
1566,998086435692425216,Sun May 20 06:22:04 +0000 2018,@PPathole Black &amp; white interior available only for Model 3 Performance initially due to limited parts availability. Will broaden over time.,874,58,932,2018-05-20
1567,998085901069598720,Sun May 20 06:19:57 +0000 2018,"Tesla AWD is dual motor, so you can fully drive the car even if one breaks",15727,1176,16903,2018-05-20
1568,998085655958769665,Sun May 20 06:18:58 +0000 2018,"Cost of all options, wheels, paint, etc  is included (apart from Autopilot). Cost is $78k. About same as BMW M3, bu… https://t.co/WFAAZTGf7E",26177,2638,28815,2018-05-20
1569,998084314200862720,Sun May 20 06:13:38 +0000 2018,"Tesla dual motor, all-wheel drive performance Model 3:
3.5 sec  0-60mph 
155 mph Top Speed
310 mile Range",41613,5024,46637,2018-05-20
1570,998083368066543616,Sun May 20 06:09:53 +0000 2018,"@plot_qasc It’s only slightly more expensive to Tesla (same price to car owners), but owner happiness is way higher, so worth doing",1708,85,1793,2018-05-20
1571,998082620427714560,Sun May 20 06:06:54 +0000 2018,@clemyeung Exactly,1902,30,1932,2018-05-20
1572,998082149356994560,Sun May 20 06:05:02 +0000 2018,Will soon enable Tesla owners to request service from their phone with a few taps. Tesla Ranger will come to you to… https://t.co/FkYeHDJpRB,60199,5145,65344,2018-05-20
1573,998080381483077632,Sun May 20 05:58:01 +0000 2018,@Everman @scottwww @KymmPuckeridge @ElementC9 @griff_golf I’m about to test the configurator &amp; then it goes out to… https://t.co/iva4zDibQ1,528,31,559,2018-05-20
1574,998079732389363714,Sun May 20 05:55:26 +0000 2018,"@AddankiSarat You can tweet to Tesla, me and/or get something upvoted in message boards",515,26,541,2018-05-20
1575,998078587805745152,Sun May 20 05:50:53 +0000 2018,@scottwww @KymmPuckeridge @ElementC9 @griff_golf That is the way to go. Thanks for buying our cars!,479,17,496,2018-05-20
1576,998024272537829376,Sun May 20 02:15:03 +0000 2018,"@DMC_Ryan Also, carbon fiber spoiler, 20” Performance wheels, black &amp; white interior.",1102,72,1174,2018-05-20
1577,998015873167208448,Sun May 20 01:41:41 +0000 2018,"@DMC_Ryan AC induction front &amp; switched reluctance, partial permanent magnet rear. Silicon Carbide inverters in bot… https://t.co/zKiLJquvQZ",1553,135,1688,2018-05-20
1578,997943053317849088,Sat May 19 20:52:19 +0000 2018,Working on Model 3 dual motor all-wheel drive &amp; performance versions. Driving feel is amazing. Aiming to release config late tonight.,44265,3923,48188,2018-05-19
1579,997379817472327680,Fri May 18 07:34:13 +0000 2018,@GothKazu Check out https://t.co/bwRt49d34V. Build-your-own life size Egyptian pantheon merch coming soon.,667,58,725,2018-05-18
1580,997379008974151681,Fri May 18 07:31:00 +0000 2018,But The Boring Company is right behind you at 1/15th your speed &amp; soon will be 1/10th! Start sweating …,18523,730,19253,2018-05-18
1581,997376304927227904,Fri May 18 07:20:16 +0000 2018,He taunts us with his speed,22087,1987,24074,2018-05-18
1582,997374648655396864,Fri May 18 07:13:41 +0000 2018,@PPathole Just … an ordinary snail,764,28,792,2018-05-18
1583,997374361651703808,Fri May 18 07:12:32 +0000 2018,His name is Gary &amp; he’s a snail,23573,3038,26611,2018-05-18
1584,997372686182449152,Fri May 18 07:05:53 +0000 2018,🐌,48385,7518,55903,2018-05-18
1585,997337626469281792,Fri May 18 04:46:34 +0000 2018,Skip forward to see the most boring presentation ever https://t.co/dD730jbggQ,12611,1150,13761,2018-05-18
1586,997279007933546497,Fri May 18 00:53:38 +0000 2018,Excited for @boringcompany partnership with LA Metro https://t.co/hpqXC3yjQ6,15582,1491,17073,2018-05-18
1587,997181669353209856,Thu May 17 18:26:51 +0000 2018,lol https://t.co/jTV7jhLWYP,11885,1104,12989,2018-05-17
1588,997005264116105217,Thu May 17 06:45:53 +0000 2018,Listening to REALiTi,33030,5051,38081,2018-05-17
1589,996947581530849281,Thu May 17 02:56:40 +0000 2018,"@kevinmitnick Yeah, there are thousands of Supercharger locations going through permitting/construction, including… https://t.co/i5HsAaHUfU",7098,212,7310,2018-05-17
1590,996703690370105350,Wed May 16 10:47:32 +0000 2018,@Manuel_Castillo Yes,1148,30,1178,2018-05-16
1591,996692386385293312,Wed May 16 10:02:37 +0000 2018,Will be presenting &amp; taking questions  about The Boring Company plans for Los Angeles at 7pm on Thursday,21907,1445,23352,2018-05-16
1592,996691566851801088,Wed May 16 09:59:21 +0000 2018,Boring Company Hyperloop will take you from city center under ground &amp; ocean to spaceport in 10 to 15 mins https://t.co/VhpfhgdXSd,23944,2537,26481,2018-05-16
1593,996326803147927552,Tue May 15 09:49:55 +0000 2018,RT @ElectrekCo: Tesla Model X breaks electric towing record by pulling a Qantas Boeing 787-9 Dreamliner https://t.co/Ss104vfbcF by @frederi…,0,2972,2972,2018-05-15
1594,996189963266936832,Tue May 15 00:46:10 +0000 2018,RT @Tesla: 140 Tesla Powerpacks now live in Belgium and balancing the European electrical grid 100 times faster than fossil fuel plants htt…,0,4962,4962,2018-05-15
1595,996134672638754816,Mon May 14 21:06:27 +0000 2018,"@andrewbg Time will tell, but so far it appears so",3106,71,3177,2018-05-14
1596,996133894893129728,Mon May 14 21:03:22 +0000 2018,"@Kasabiii It certainly needs to be better &amp; we work to improve it every day, but perfect is enemy of good. A system… https://t.co/qg2yNhufQE",4712,475,5187,2018-05-14
1597,996132429772410882,Mon May 14 20:57:33 +0000 2018,What’s actually amazing about this accident is that a Model S hit a fire truck at 60mph and the driver only broke a… https://t.co/wFFGD98gIC,86259,11484,97743,2018-05-14
1598,996131586469842945,Mon May 14 20:54:12 +0000 2018,"It’s super messed up that a Tesla crash resulting in a broken ankle is front page news and the ~40,000 people who d… https://t.co/Kr5jG0OYO3",114902,25375,140277,2018-05-14
1599,996121794246426625,Mon May 14 20:15:17 +0000 2018,@sokane1 @TalkTesla @Techmeme @timkhiggins Yes,741,22,763,2018-05-14
1600,996112995636858880,Mon May 14 19:40:19 +0000 2018,"@TalkTesla @Techmeme @timkhiggins According to NHTSA, there was an automotive fatality every 86M miles in 2017 (~40… https://t.co/0wSxRMKM9d",4817,808,5625,2018-05-14
1601,996102919811350528,Mon May 14 19:00:17 +0000 2018,"@Techmeme @timkhiggins This is false. Eyetracking rejected for being ineffective, not for cost. WSJ fails to mentio… https://t.co/BXPQRFKSI4",22922,2484,25406,2018-05-14
1602,995823298888990720,Mon May 14 00:29:10 +0000 2018,@mayemusk Happy Mother’s Day Mom! Love you so much.,6140,140,6280,2018-05-14
1603,995822814291673090,Mon May 14 00:27:15 +0000 2018,"@arstechnica Fair criticism, but we’re fixing it fast. Hackathon going on right now to fix 2 worst robot production… https://t.co/xB1TV3TKlF",9319,393,9712,2018-05-14
1604,995820634125959168,Mon May 14 00:18:35 +0000 2018,RT @SpaceX: More photos from the first flight of Falcon 9 Block 5 → https://t.co/095WHWMtKp https://t.co/4gZsAc01Bg,0,4616,4616,2018-05-14
1605,995820124656484352,Mon May 14 00:16:33 +0000 2018,Lovely story https://t.co/fIsvSIx3Uu,58546,3999,62545,2018-05-14
1606,995479302660505600,Sun May 13 01:42:15 +0000 2018,"@devrim_ogun @RitaJKing If someone is trying to control us through complicated sky patterns, they must really care.… https://t.co/7vR5iEyJb9",862,71,933,2018-05-13
1607,995462943079723008,Sun May 13 00:37:15 +0000 2018,@Everman SpaceX will prob build 30 to 40 rocket cores for ~300 missions over 5 years. Then BFR takes over &amp; Falcon… https://t.co/jWKmcmc7bS,1808,290,2098,2018-05-13
1608,995461033958424576,Sun May 13 00:29:39 +0000 2018,Good piece by Ars https://t.co/7C3X0TjUX9,10799,1049,11848,2018-05-13
1609,995449059535015936,Sat May 12 23:42:04 +0000 2018,@RitaJKing Rate at which things are getting more bizarre appears to be increasing,5882,393,6275,2018-05-12
1610,995447960895864832,Sat May 12 23:37:43 +0000 2018,"@DylanNeumann2 @Everman Exactly. Gasoline cars will be like steam engines — quaint, but not something you’d actuall… https://t.co/JDrpps6G7K",1017,80,1097,2018-05-12
1611,995446819369844739,Sat May 12 23:33:10 +0000 2018,"@Everman Yeah, I heard this so many times. In the future, it will seem bizarre that we used to crash rockets into t… https://t.co/Ri05gjrxA4",13423,1105,14528,2018-05-12
1612,995180203440680960,Sat May 12 05:53:44 +0000 2018,RT @SpaceX: Falcon 9 Block 5 first stage has landed on the Of Course I Still Love You droneship. https://t.co/YHqdxIrc8b,0,6867,6867,2018-05-12
1613,995125446634188800,Sat May 12 02:16:09 +0000 2018,@boringcompany Yo,31063,1742,32805,2018-05-12
1614,995067149302484992,Fri May 11 22:24:30 +0000 2018,@PodcastTeslas Will make that a setting,598,23,621,2018-05-11
1615,995066192938192897,Fri May 11 22:20:42 +0000 2018,"@existentialcoms Fossil fuels subsidized at $10 million a minute, 24 hours a day, 7 days a week https://t.co/zAZOohjb4E",949,219,1168,2018-05-11
1616,995065228403458048,Fri May 11 22:16:52 +0000 2018,@existentialcoms No use arguing with chimp. You’re blocked.,1743,195,1938,2018-05-11
1617,995061978140819456,Fri May 11 22:03:57 +0000 2018,@existentialcoms That article was pushed as propaganda to counter IMF study showing fossil fuel subsidies to be $5… https://t.co/MLIKT7Ex3a,1828,135,1963,2018-05-11
1618,995054585973633024,Fri May 11 21:34:35 +0000 2018,RT @SpaceX: Successful deployment of Bangabandhu Satellite-1 to geostationary transfer orbit confirmed. https://t.co/aX7kRQtBpZ,0,3051,3051,2018-05-11
1619,995050249327525888,Fri May 11 21:17:21 +0000 2018,RT @thesheetztweetz: Look at the relief from @elonmusk on the @SpaceX livestream – you can tell how important this first #Block5 mission wa…,0,1113,1113,2018-05-11
1620,995033832796577792,Fri May 11 20:12:07 +0000 2018,@archangel_cap @existentialcoms I have publicly asked people (like you) not to invest. Go fund Ford or whatever  …,2175,186,2361,2018-05-11
1621,995033279731384320,Fri May 11 20:09:55 +0000 2018,Launching in ~4 mins https://t.co/4vMvdEQAx7,15769,1389,17158,2018-05-11
1622,995029619655954432,Fri May 11 19:55:22 +0000 2018,"@DMC_Ryan @AnthonyFultz AWD &amp; white interior in July. Air suspension prob later. Note, that’s when we *start* makin… https://t.co/VbPq13rb8Z",822,77,899,2018-05-11
1623,995028864672788480,Fri May 11 19:52:22 +0000 2018,"@existentialcoms Our giant auto co competitors have much greater access to incentives than Tesla, which means Tesla… https://t.co/fWdbobFQUp",12987,928,13915,2018-05-11
1624,995021099518709760,Fri May 11 19:21:31 +0000 2018,"@AnthonyFultz @DMC_Ryan I love it too, but trying to keep config simple so as not to blow up the production ramp",556,23,579,2018-05-11
1625,994980692160217088,Fri May 11 16:40:57 +0000 2018,@DMC_Ryan Tesla will enable orders end of next week for dual motor AWD &amp; performance. Starting production of those… https://t.co/j01KKPqPRF,1727,274,2001,2018-05-11
1626,994977264864382976,Fri May 11 16:27:20 +0000 2018,RT @ElectrekCo: Tesla’s giant battery in Australia reduced grid service cost by 90% https://t.co/vzKgWm742S by @fredericlambert https://t.c…,0,1825,1825,2018-05-11
1627,994762365882089472,Fri May 11 02:13:24 +0000 2018,@nextspaceflight A cool thing about the design is that’s easy to incorporate branch loops to serve small to mid siz… https://t.co/zZeOtLQfVl,2938,162,3100,2018-05-11
1628,994760815361245184,Fri May 11 02:07:14 +0000 2018,"@MissTrade Already started DC to NY route. 
Hopefully start LA to SF next year. That will be true @Hyperloop w pres… https://t.co/ReSWBhVMqk",5638,534,6172,2018-05-11
1629,994759514082684928,Fri May 11 02:02:04 +0000 2018,First Boring Company tunnel under LA almost done! Pending final… https://t.co/oWHlwOgCJE,30909,3988,34897,2018-05-11
1630,994739393859502082,Fri May 11 00:42:07 +0000 2018,"@isayeter Towards end of next year. Btw, planning to launch Tesla in Turkey later this year. Love your country &amp; wi… https://t.co/jQZhXpJO9C",2736,708,3444,2018-05-11
1631,994738852253155328,Fri May 11 00:39:58 +0000 2018,"@tammyharrington @Josh1C This will work on entire S &amp; X fleet, even first production units. Cool thing about softwa… https://t.co/R8NmcKc4OJ",615,48,663,2018-05-11
1632,994737453041729536,Fri May 11 00:34:24 +0000 2018,RT @SpaceX: Standing down today due to a standard ground system auto abort at T-1 min. Rocket and payload are in good health—teams are work…,0,1743,1743,2018-05-11
1633,994634863608152064,Thu May 10 17:46:45 +0000 2018,RT @SpaceX: Falcon 9 Block 5 and Bangabandhu Satellite-1 went vertical on Pad 39A in Florida this morning. Now targeting liftoff at 4:42 p.…,0,2560,2560,2018-05-10
1634,994535342739832832,Thu May 10 11:11:17 +0000 2018,"@Josh1C All X &amp; S will soon work with no key if your phone pairs w Bluetooth, signal strength is high &amp; you enable feature",916,67,983,2018-05-10
1635,994534448442916864,Thu May 10 11:07:44 +0000 2018,"@Josh1C Yeah, we will add that as a feature",4635,100,4735,2018-05-10
1636,994534079591665664,Thu May 10 11:06:16 +0000 2018,@simona_moise @MacTechGenius @teslanomicsco @Wayfair @TeslaClubSweden !! Unnecessary characters. Will change.,524,16,540,2018-05-10
1637,994521953754058752,Thu May 10 10:18:05 +0000 2018,@MacTechGenius @teslanomicsco @Wayfair @TeslaClubSweden I wrote that masterpiece myself in HTML 1.0,842,32,874,2018-05-10
1638,994468381897048069,Thu May 10 06:45:13 +0000 2018,"@teslanomicsco @Wayfair @TeslaClubSweden Wow, thanks for the couch! I will match the donation from my foundation.",5610,204,5814,2018-05-10
1639,994460875208691717,Thu May 10 06:15:23 +0000 2018,@alyankovic @Grimezsz My a capella cover of Amish Paradise is irresistible https://t.co/mBo6aJV42O,4151,250,4401,2018-05-10
1640,994413269241675776,Thu May 10 03:06:13 +0000 2018,RT @Tesla: Wild horses in winter at Gigafactory 1 https://t.co/bbGp9NwBbq,0,3621,3621,2018-05-10
1641,994381742646554625,Thu May 10 01:00:56 +0000 2018,Tesla quarterly all-hands video. Love the shot of wild horses &amp; Giga in winter https://t.co/ZGZbpSFhus,13757,2204,15961,2018-05-10
1642,994359266617188352,Wed May 09 23:31:38 +0000 2018,@freebasecatnip So rococo,6596,261,6857,2018-05-09
1643,994335585316757504,Wed May 09 21:57:32 +0000 2018,"RT @Tesla: 50 million Americans say their next vehicle will be electric
https://t.co/z6rRoWKFzc",0,2946,2946,2018-05-09
1644,994308016517271552,Wed May 09 20:07:59 +0000 2018,@ablack82 Definitely not a logo of any kind,632,16,648,2018-05-09
1645,994279996725215232,Wed May 09 18:16:38 +0000 2018,@MeriamMagic @CatherineUllo Stole it,485,13,498,2018-05-09
1646,994270544496226304,Wed May 09 17:39:05 +0000 2018,@NannySoleil @CatherineUllo We sketched concept together &amp; worked w a trusted team to make it,622,16,638,2018-05-09
1647,994269435077644289,Wed May 09 17:34:40 +0000 2018,@CatherineUllo Glass corset hand-painted in perspective in color of bone. Every detail tells a story. Spiked choker… https://t.co/aNzdQ6zobm,680,28,708,2018-05-09
1648,994267584764628992,Wed May 09 17:27:19 +0000 2018,@DanielleFong @paracurve Hi Danielle!,1002,17,1019,2018-05-09
1649,994266252779470849,Wed May 09 17:22:01 +0000 2018,"@paracurve Don’t want to blow your mind, but I’m pretty weird. It’s time the world knew.",5914,618,6532,2018-05-09
1650,994265259421548544,Wed May 09 17:18:05 +0000 2018,"Night at the museum. G has mad skillzsz. Me not so much.
https://t.co/xFhGncvMhH",16837,1210,18047,2018-05-09
1651,994095355351502848,Wed May 09 06:02:56 +0000 2018,@MaxHandwerker @dan_rar @ProSyndicate @nypost Literally every word is untrue,2237,83,2320,2018-05-09
1652,994055600232321024,Wed May 09 03:24:58 +0000 2018,"@nypost That’s a white rose on my jacket &amp; the choker is a bunch of spikes, not Tesla anything",26553,1261,27814,2018-05-09
1653,994025286260867074,Wed May 09 01:24:30 +0000 2018,@MarinPilates @WeDragonSlayers This chart shows how crazy low payout is to labels &amp; the artists only a small fracti… https://t.co/kv1Il2AqOq,1438,398,1836,2018-05-09
1654,994024101399293953,Wed May 09 01:19:48 +0000 2018,"@MarinPilates @WeDragonSlayers Prob iTunes, but whatever works 4u is fine. Most people don’t buy music &amp; artist ear… https://t.co/TRPogQ18gb",414,29,443,2018-05-09
1655,993995967610290176,Tue May 08 23:28:00 +0000 2018,@WeDragonSlayers Flesh without Blood &amp; Kill V Maim on Art Angels album https://t.co/MycGWvbYGk,5280,1020,6300,2018-05-08
1656,993993468111241216,Tue May 08 23:18:04 +0000 2018,"@Grimezsz Love Powerglide too 
https://t.co/l07YbZLdIG",2903,648,3551,2018-05-08
1657,993702782073962496,Tue May 08 04:03:00 +0000 2018,RT @SpaceX: Targeting Falcon 9 Block 5 launch of Bangabandhu Satellite-1 on May 10 from Pad 39A in Florida.,0,2239,2239,2018-05-08
1658,993667352888791040,Tue May 08 01:42:13 +0000 2018,@UJZEEE @ProductHunt @shnbhg Yes,530,15,545,2018-05-08
1659,993593145064673281,Mon May 07 20:47:20 +0000 2018,https://t.co/WavNr0ZtDn https://t.co/Z5w69RXtxu,16065,1912,17977,2018-05-07
1660,993575688778256385,Mon May 07 19:37:58 +0000 2018,https://t.co/OgAHAWkNkU,4444,229,4673,2018-05-07
1661,993572598381514753,Mon May 07 19:25:41 +0000 2018,Rococo basilisk,15846,1457,17303,2018-05-07
1662,993546386518966275,Mon May 07 17:41:32 +0000 2018,@drmistercody The Boring Company will be using dirt from tunnel digging to create bricks for low cost housing,28415,2783,31198,2018-05-07
1663,992970026108907520,Sun May 06 03:31:17 +0000 2018,"@silverblue16 (Sigh) I do like Ty, but she’s a friend. We are not dating.",696,36,732,2018-05-06
1664,992964829282418688,Sun May 06 03:10:38 +0000 2018,Saying you like “moats” is just a nice way of saying you like oligopolies,14657,1192,15849,2018-05-06
1665,992951528255250432,Sun May 06 02:17:47 +0000 2018,Warren Buffett is huge in candy. It’s actually true. https://t.co/UqzIxPGCM2,16248,1304,17552,2018-05-06
1666,992941109222391808,Sun May 06 01:36:23 +0000 2018,I’m killin me lol,108607,23932,132539,2018-05-06
1667,992940263906553857,Sun May 06 01:33:01 +0000 2018,@SarahKSilverman lol,1365,71,1436,2018-05-06
1668,992937572698472454,Sun May 06 01:22:19 +0000 2018,@SarahKSilverman Hi Sarah,1840,46,1886,2018-05-06
1669,992924525288308736,Sun May 06 00:30:29 +0000 2018,Then I’m going to build a moat &amp; fill it w candy. Warren B will not be able to resist investing! Berkshire Hathaway kryptonite …,35282,2961,38243,2018-05-06
1670,992904076978540545,Sat May 05 23:09:13 +0000 2018,Cryptocandy,56826,8296,65122,2018-05-05
1671,992894802122366976,Sat May 05 22:32:22 +0000 2018,"Ok ok, just for sake of argument, what do u wish for in candy? 🍭",40506,2325,42831,2018-05-05
1672,992891529852108800,Sat May 05 22:19:22 +0000 2018,@ComfortablySmug What do you think we’re living in?,27071,2241,29312,2018-05-05
1673,992890073908572160,Sat May 05 22:13:35 +0000 2018,It just occurred to me that the plot of Willy Wonka is really messed up,94369,9354,103723,2018-05-05
1674,992876773695082496,Sat May 05 21:20:44 +0000 2018,I am super super serious,97741,9010,106751,2018-05-05
1675,992876606979952640,Sat May 05 21:20:04 +0000 2018,I’m starting a candy company &amp; it’s going to be amazing,255684,42646,298330,2018-05-05
1676,992872154927542273,Sat May 05 21:02:23 +0000 2018,https://t.co/GUnnlJoPbU https://t.co/7tMzFk8v9G,6321,675,6996,2018-05-05
1677,992870391847649280,Sat May 05 20:55:22 +0000 2018,@muddywatersre This will be bigger,613,43,656,2018-05-05
1678,992558985218789376,Sat May 05 00:17:57 +0000 2018,@filippie509 I try so hard to help them …,1232,50,1282,2018-05-05
1679,992558443872575489,Sat May 05 00:15:48 +0000 2018,@ATeslaInICEland @Tesla Thanks for letting me know. Will expedite. Sorry for the delay.,6292,162,6454,2018-05-05
1680,992556974263947264,Sat May 05 00:09:58 +0000 2018,"Looks like sooner than expected. The sheer magnitude of short carnage will be unreal. If you’re short, I suggest ti… https://t.co/p7TIVLrRnG",12193,1153,13346,2018-05-05
1681,992511425753956352,Fri May 04 21:08:58 +0000 2018,@TobyTurner New Roadster will have that,13009,443,13452,2018-05-04
1682,992391704333320192,Fri May 04 13:13:14 +0000 2018,"@InvestorsLive Yes, definitely not",2696,60,2756,2018-05-04
1683,992391093688791050,Fri May 04 13:10:49 +0000 2018,@FredericLambert It will be next level. These are really big numbers.,1822,76,1898,2018-05-04
1684,992388944774938626,Fri May 04 13:02:16 +0000 2018,Oh and uh short burn of the century comin soon. Flamethrowers should arrive just in time.,45425,3169,48594,2018-05-04
1685,992384341912137733,Fri May 04 12:43:59 +0000 2018,@mr_calico @FredericLambert Yup,529,20,549,2018-05-04
1686,992381848104747008,Fri May 04 12:34:04 +0000 2018,"@GlobalProTrader @wmiddelkoop True. And once they were on the call, I should have answered their questions live. It… https://t.co/8NdWCCvVrq",909,65,974,2018-05-04
1687,992378642830262272,Fri May 04 12:21:20 +0000 2018,@joshgans We went through the same drama on S &amp; X and almost all confirmed in the end. Will likely be even better f… https://t.co/2r5pGHsHEJ,1708,135,1843,2018-05-04
1688,992374493132742656,Fri May 04 12:04:51 +0000 2018,"Reason RBC question about Model 3 demand is absurd is that Tesla has roughly half a million reservations, despite n… https://t.co/pGW7p4oKAo",18212,1817,20029,2018-05-04
1689,992372195304198144,Fri May 04 11:55:43 +0000 2018,The reason the Bernstein question about CapEx was boneheaded was that it had already been answered in the headline… https://t.co/auGKnq4hPg,10931,659,11590,2018-05-04
1690,992367087761817600,Fri May 04 11:35:25 +0000 2018,"The 2 questioners I ignored on the Q1 call are sell-side analysts who represent a short seller thesis, not investors",9658,695,10353,2018-05-04
1691,992362814353293312,Fri May 04 11:18:26 +0000 2018,@MarekCyzio Exactly,4708,98,4806,2018-05-04
1692,992362594961780742,Fri May 04 11:17:34 +0000 2018,"First, it’s important to know that Tesla is the most shorted (meaning most bet against) stock on the market &amp; has b… https://t.co/aT6ihkeGH4",10830,1007,11837,2018-05-04
1693,992361223793487872,Fri May 04 11:12:07 +0000 2018,Please ignore this thread unless you’re interested in a tedious discussion about Tesla stock,38944,4131,43075,2018-05-04
1694,992354361975042048,Fri May 04 10:44:51 +0000 2018,@Ataraxia_Invest @MKBHD @HyperChangeTV They were neither valid nor pertinent. I will explain why on a primary Twitter thread.,584,29,613,2018-05-04
1695,992341387613016064,Fri May 04 09:53:18 +0000 2018,"@ThePhoenixFlare @MKBHD @HyperChangeTV Yeah, news is actually super good. Model S &amp; X are producing major positive… https://t.co/jP06OClC61",810,63,873,2018-05-04
1696,992337618091298816,Fri May 04 09:38:19 +0000 2018,"@MKBHD @HyperChangeTV To be clear, I’m a big fan of MKBHD, but this is an important clarification",10329,643,10972,2018-05-04
1697,992333108346277888,Fri May 04 09:20:24 +0000 2018,"@MKBHD @HyperChangeTV The “dry” questions were not asked by investors, but rather by two sell-side analysts who wer… https://t.co/DWrvNgJ1cF",6012,371,6383,2018-05-04
1698,991944456466202624,Thu May 03 07:36:02 +0000 2018,You’re most welcome https://t.co/5lOHSWHWhc,10637,635,11272,2018-05-03
1699,991813680533684224,Wed May 02 22:56:23 +0000 2018,@drgitlin Your numbers are incorrect. Tesla Fremont is 3rd in world after a 🇳🇱🌸 place &amp; 🇦🇪 mall. Giga will be large… https://t.co/mhJRIxBIrZ,834,75,909,2018-05-02
1700,991788131153215489,Wed May 02 21:14:51 +0000 2018,Woke Frisbee https://t.co/jSvZyQbZ6O,5704,417,6121,2018-05-02
1701,991786023351869441,Wed May 02 21:06:29 +0000 2018,"La la la
https://t.co/rLQfmrcNO2",53369,6346,59715,2018-05-02
1702,991784449275670528,Wed May 02 21:00:13 +0000 2018,@arstechnica SpaceX Crew Dragon ships to the Cape in about 3 months,6223,560,6783,2018-05-02
1703,991752018338304000,Wed May 02 18:51:21 +0000 2018,@arstechnica @binarybits 🖤 Ars Technica 🖤,3195,116,3311,2018-05-02
1704,991556953586503680,Wed May 02 05:56:14 +0000 2018,Falcon 9 fairing opens its parafoil after reentering the atmosphere https://t.co/WWz7MhmKaM,17571,1783,19354,2018-05-02
1705,991130075889205248,Tue May 01 01:39:59 +0000 2018,@Gfilche @Tesla Ok,5354,232,5586,2018-05-01
1706,991007702724689920,Mon Apr 30 17:33:43 +0000 2018,@DianaKFletcher That’s how I use my eyebrows too,1920,65,1985,2018-04-30
1707,990854677926297600,Mon Apr 30 07:25:39 +0000 2018,I have prehensile eyebrows,42303,3305,45608,2018-04-30
1708,990040963635597312,Sat Apr 28 01:32:14 +0000 2018,@cloudstrife447 @Grimezsz 😉,1318,130,1448,2018-04-28
1709,990028017861705729,Sat Apr 28 00:40:47 +0000 2018,"@Grimezsz Yeah, most people don’t know this, but comets r mostly made of cocaine",3280,889,4169,2018-04-28
1710,989986716004958208,Fri Apr 27 21:56:40 +0000 2018,@WorldAndScience Almost ready to test the new Boring Company / SpaceX hyperpod prototype. Exciting video guaranteed.,27839,2144,29983,2018-04-27
1711,989598167980163072,Thu Apr 26 20:12:43 +0000 2018,https://t.co/3ZyzXoJjcc https://t.co/Er71Qz68Rh,27028,4970,31998,2018-04-26
1712,989362154242428928,Thu Apr 26 04:34:53 +0000 2018,@GameOfThrones Don’t make me use my space lasers …,43658,4519,48177,2018-04-26
1713,989199502794936321,Wed Apr 25 17:48:34 +0000 2018,@illbzo1 I know … such an underserved market,28004,917,28921,2018-04-25
1714,989198118666162176,Wed Apr 25 17:43:04 +0000 2018,Oh btw I’m building a cyborg dragon,467845,108242,576087,2018-04-25
1715,989195682081730560,Wed Apr 25 17:33:23 +0000 2018,@Grimezsz @PostMalone Sounds great riding my cyborg 🐉,1440,104,1544,2018-04-25
1716,989017019876966400,Wed Apr 25 05:43:27 +0000 2018,@PostMalone Likewise … was just listening to Go Flex &amp; Psycho on @Grimezsz playlist,13265,1319,14584,2018-04-25
1717,988295060985806848,Mon Apr 23 05:54:38 +0000 2018,RT @kanyewest: This is the funnest car I’ve ever driven,0,5421,5421,2018-04-23
1718,988294892219654144,Mon Apr 23 05:53:58 +0000 2018,RT @kanyewest: I really love my Tesla. I'm in the future. Thank you Elon.,0,26988,26988,2018-04-23
1719,988218070102519808,Mon Apr 23 00:48:42 +0000 2018,RT @ElectrekCo: Tesla’s fleet has driven 7.2 billion miles and its energy products produced 10.3 billion kWh https://t.co/wF8Do5UPPq by @fr…,0,1189,1189,2018-04-23
1720,988214241797685248,Mon Apr 23 00:33:30 +0000 2018,@MrAdamPrater Mostly not,465,23,488,2018-04-23
1721,988209261565001728,Mon Apr 23 00:13:42 +0000 2018,RT @Tesla: The night sky above the Tesla South Australia Powerpack Project. Happy Earth Day https://t.co/4Kw3X0Iv4k,0,7196,7196,2018-04-23
1722,986850982138032128,Thu Apr 19 06:16:23 +0000 2018,RT @NASA: How many worlds exist outside our solar system? @NASA_TESS launched from planet Earth today at 6:51pm ET to hunt for planets arou…,0,4558,4558,2018-04-19
1723,986746909153869824,Wed Apr 18 23:22:50 +0000 2018,Tesla batteries are currently live &amp; delivering power at 662 locations in Puerto Rico. Team is working 24/7 to acti… https://t.co/EVBMrsxu3k,162737,36133,198870,2018-04-18
1724,986738164478787584,Wed Apr 18 22:48:05 +0000 2018,RT @SpaceX: Webcast of Falcon 9 launch is now live → https://t.co/gtC39uBC7z,0,1522,1522,2018-04-18
1725,986641687081398272,Wed Apr 18 16:24:43 +0000 2018,@arstechnica @SciGuySpace Russia has great rocket technology &amp; talent. Much respect. Would encourage focus on reusa… https://t.co/UFFdWAHXBG,8370,660,9030,2018-04-18
1726,986632786659299328,Wed Apr 18 15:49:21 +0000 2018,"RT @SpaceX: All systems and weather are go for Falcon 9’s launch of @NASA_TESS today at 6:51 p.m. EDT, or 22:51 UTC. https://t.co/gtC39uBC7…",0,3517,3517,2018-04-18
1727,986632708074827777,Wed Apr 18 15:49:03 +0000 2018,@vincechen Doing our best,483,22,505,2018-04-18
1728,986369127907393537,Tue Apr 17 22:21:40 +0000 2018,https://t.co/MMRtF3jHD5,3195,230,3425,2018-04-17
1729,986363212474925056,Tue Apr 17 21:58:10 +0000 2018,https://t.co/JIl6vzhQAx,5112,471,5583,2018-04-17
1730,986361795894919168,Tue Apr 17 21:52:32 +0000 2018,https://t.co/dEOd5GKfdk,5278,480,5758,2018-04-17
1731,986360329763307520,Tue Apr 17 21:46:42 +0000 2018,Now https://t.co/4CLYzLR9mk,3489,274,3763,2018-04-17
1732,986322814985584640,Tue Apr 17 19:17:38 +0000 2018,Driving a Model 3 and playing https://t.co/5xa3FUWuXy,15742,1838,17580,2018-04-17
1733,986070683426766848,Tue Apr 17 02:35:45 +0000 2018,"@QuinnKupec @SpaceX @UofMaryland Yeah, exactly! Would be great to hear your thoughts. We’re going to try a few appr… https://t.co/jF9XuV33Sj",780,49,829,2018-04-17
1734,985731208846831618,Mon Apr 16 04:06:48 +0000 2018,@smartereveryday @BadAstronomer We already do targeted retro burn to a specific point in Pacific w no islands or sh… https://t.co/ABQtp0AgHh,1329,96,1425,2018-04-16
1735,985684755877265408,Mon Apr 16 01:02:13 +0000 2018,And then land on a bouncy house,73025,6776,79801,2018-04-16
1736,985668304353116161,Sun Apr 15 23:56:51 +0000 2018,"@BadAstronomer Yeah, but great for creating a giant object that retains its shape across all Mach regimes &amp; drops b… https://t.co/Uf1xL17IJ9",2760,204,2964,2018-04-15
1737,985655249745592320,Sun Apr 15 23:04:58 +0000 2018,SpaceX will try to bring rocket upper stage back from orbital velocity using a giant party balloon,105461,14962,120423,2018-04-15
1738,985654333860601856,Sun Apr 15 23:01:20 +0000 2018,"This is gonna sound crazy, but …",80091,10237,90328,2018-04-15
1739,985361761271406594,Sun Apr 15 03:38:45 +0000 2018,Interview and Tesla factory tour with Gayle King https://t.co/693jZBk4Km,22878,3028,25906,2018-04-15
1740,985345850946699264,Sun Apr 15 02:35:32 +0000 2018,@La3_id @TheOnion  https://t.co/qOyH1VVBVp,2897,403,3300,2018-04-15
1741,985344228665393152,Sun Apr 15 02:29:05 +0000 2018,@La3_id @TheOnion Too wasted to remember,1859,202,2061,2018-04-15
1742,985343867108012032,Sun Apr 15 02:27:39 +0000 2018,"@TheOnion Don’t want to brag or anything, but that happens to me sometimes …",15642,765,16407,2018-04-15
1743,984882630947753984,Fri Apr 13 19:54:52 +0000 2018,"@timkhiggins Yes, excessive automation at Tesla was a mistake. To be precise, my mistake. Humans are underrated.",41434,7909,49343,2018-04-13
1744,984705630106673152,Fri Apr 13 08:11:31 +0000 2018,"@TheEconomist The Economist used to be boring, but smart with a wicked dry wit. Now it’s just boring (sigh). Tesla… https://t.co/nA9E1P5vxb",18840,1957,20797,2018-04-13
1745,984702246817431553,Fri Apr 13 07:58:05 +0000 2018,"@Taysh83 @Tesla Sorry, demand has been higher than expected. Making them as fast as possible, but waitlist is 3 to 6 months.",707,41,748,2018-04-13
1746,984700711425355777,Fri Apr 13 07:51:59 +0000 2018,@BenMcLeish @Tesla Looking into it. This is bizarre.,635,19,654,2018-04-13
1747,984689905874817029,Fri Apr 13 07:09:02 +0000 2018,@VoltzCoreAudio @TEDTalks @audphin @i_firth Maybe a little 😉,928,51,979,2018-04-13
1748,984650810909851648,Fri Apr 13 04:33:41 +0000 2018,@TEDTalks @audphin @i_firth Gwynne’s got it covered. She’s awesome.,1495,70,1565,2018-04-13
1749,984650518088658944,Fri Apr 13 04:32:32 +0000 2018,"RT @Tesla: Batteries cut costs and respond to major power problems quicker than coal, gas or hydro generators https://t.co/g3BhJbW4Rq https…",0,2910,2910,2018-04-13
1750,984517995400650752,Thu Apr 12 19:45:56 +0000 2018,@audphin @TEDTalks @i_firth I love trolls,1304,85,1389,2018-04-12
1751,984498847232622592,Thu Apr 12 18:29:50 +0000 2018,@TEDTalks @i_firth Norway has some really cool tunnels and bridges,7801,366,8167,2018-04-12
1752,983863209491775488,Wed Apr 11 00:24:03 +0000 2018,@AshleyEsqueda @petesjca @monitron @Tesla Should be fully fixed within the next few days,612,23,635,2018-04-11
1753,983775391851528192,Tue Apr 10 18:35:05 +0000 2018,@volgaksoy @visageofscott Place your bets …,1293,132,1425,2018-04-10
1754,983621641262399489,Tue Apr 10 08:24:08 +0000 2018,@PDChina This is a very important action by China. Avoiding a trade war will benefit all countries.,1448,192,1640,2018-04-10
1755,983438824452669440,Mon Apr 09 20:17:41 +0000 2018,@chrispaine @DoYouTrust How many views?,3217,70,3287,2018-04-09
1756,983207596298522626,Mon Apr 09 04:58:52 +0000 2018,SpaceX main body tool for the BFR interplanetary spaceship https://t.co/WbTITI6WSu,20805,3082,23887,2018-04-09
1757,983159549116010496,Mon Apr 09 01:47:57 +0000 2018,Free viewing ends in about 5 hours https://t.co/bracGDFd0r,17652,2851,20503,2018-04-09
1758,982878098663161856,Sun Apr 08 07:09:34 +0000 2018,@srinivasguduru @mathetes76 @monitron @Tesla Definitely. Will take corrective action immediately. Sorry about this.,994,41,1035,2018-04-08
1759,982874182617722880,Sun Apr 08 06:54:00 +0000 2018,@mathetes76 @monitron @Tesla Looking into it now,656,17,673,2018-04-08
1760,982864331338432513,Sun Apr 08 06:14:51 +0000 2018,@monitron @Tesla Should just be due to your config not avail yet. If not lmk.,524,16,540,2018-04-08
1761,982850314054205440,Sun Apr 08 05:19:10 +0000 2018,@razemfrazem @bvledford @Tesla Similar timing,659,25,684,2018-04-08
1762,982849024083484673,Sun Apr 08 05:14:02 +0000 2018,@bvledford @Tesla So probably July,820,41,861,2018-04-08
1763,982848849361289222,Sun Apr 08 05:13:20 +0000 2018,@bvledford @Tesla We need to achieve 5k/week with Model 3 before adding complexity that would inhibit production ramp,3696,155,3851,2018-04-08
1764,982830466913845250,Sun Apr 08 04:00:18 +0000 2018,"This is kinda nutty for such a short distance, so could easily end up being shredded metal, but exciting either way",14374,808,15182,2018-04-08
1765,982826517443915776,Sun Apr 08 03:44:36 +0000 2018,Upgraded SpaceX/Tesla Hyperloop pod speed test soon. Will try to reach half speed of sound (and brake) within ~1.2km.,14043,1207,15250,2018-04-08
1766,982810679064199168,Sun Apr 08 02:41:40 +0000 2018,@anshulbhide @Tesla Model 3 is the whole point. We only made the more expensive cars in order to make the mass-mark… https://t.co/mBQpuIsahR,10943,714,11657,2018-04-08
1767,982717418446512128,Sat Apr 07 20:31:05 +0000 2018,@JohnnaSabri The cat videos are awesome 🐱,1055,68,1123,2018-04-07
1768,982716415089299457,Sat Apr 07 20:27:06 +0000 2018,https://t.co/WehHd0eJeO at 5M views after 36 hours. Congrats to Chris Paine &amp; co!,17681,2658,20339,2018-04-07
1769,982168698600353792,Fri Apr 06 08:10:40 +0000 2018,@Markjvolgin Exactly,1165,25,1190,2018-04-06
1770,982168099582431232,Fri Apr 06 08:08:17 +0000 2018,"“You are my creator, but I am your master” — Mary Shelley",52975,7222,60197,2018-04-06
1771,982166600601124865,Fri Apr 06 08:02:20 +0000 2018,In memory of Stephen Hawking,20396,1210,21606,2018-04-06
1772,982119546420002817,Fri Apr 06 04:55:21 +0000 2018,Nothing will affect the future of humanity more than digital super-intelligence. Watch Chris Paine’s new AI movie f… https://t.co/0vpd97vKdx,51856,15977,67833,2018-04-06
1773,982017761575518208,Thu Apr 05 22:10:54 +0000 2018,Chris Paine AI movie premiering tonight https://t.co/kXM7USFi8D,14784,2704,17488,2018-04-05
1774,981975289403076610,Thu Apr 05 19:22:07 +0000 2018,@teslatidbits @Tesla We will add a feature to allow request of latest software version,2680,89,2769,2018-04-05
1775,981659052768817153,Wed Apr 04 22:25:31 +0000 2018,@Complex This is false,19322,2757,22079,2018-04-04
1776,981581401639198720,Wed Apr 04 17:16:57 +0000 2018,"@rosechehrazi Oh, it’s on …",4417,195,4612,2018-04-04
1777,981581215344939008,Wed Apr 04 17:16:13 +0000 2018,Most people don’t know there’s a whole box of Easter eggs with every Tesla. Just tap logo on center screen &amp; wait.… https://t.co/CgWaV6amQZ,31080,2382,33462,2018-04-04
1778,981127909170593792,Tue Apr 03 11:14:56 +0000 2018,RT @TIME: SpaceX just launched an experimental space junk sweeper into orbit https://t.co/XCQKxHqQpY,0,2440,2440,2018-04-03
1779,980913452976816128,Mon Apr 02 21:02:46 +0000 2018,"@amir Uhh, hello, I need to build cars",3394,337,3731,2018-04-02
1780,980913157739765761,Mon Apr 02 21:01:35 +0000 2018,"@amir About a year ago, I asked Doug to manage both engineering &amp; production. He agreed that Tesla needed eng &amp; pro… https://t.co/CEdLGq8Ht6",2311,190,2501,2018-04-02
1781,980910671763193856,Mon Apr 02 20:51:43 +0000 2018,"@amir Can’t believe you’re even writing about this. My job as CEO is to focus on what’s most critical, which is cur… https://t.co/vLDyiKc1yo",11370,610,11980,2018-04-02
1782,980892800324575232,Mon Apr 02 19:40:42 +0000 2018,"@vegamontesino @NoceraBV @WSJ @Tesla We release as soon as we have the data. Good timeline, bad timing. Doesn’t matter.",2704,89,2793,2018-04-02
1783,980885178942816256,Mon Apr 02 19:10:25 +0000 2018,"@NoceraBV @WSJ @Tesla Not criticizing, just as asking questions. I’m sure there’s a really great answer …",3696,77,3773,2018-04-02
1784,980883549074018304,Mon Apr 02 19:03:56 +0000 2018,@WSJ Tesla policy is to issue a recall *before* there are injuries. This is absolutely the right thing to do. Yet t… https://t.co/WdOPhZHUSv,40653,5076,45729,2018-04-02
1785,980880706627715072,Mon Apr 02 18:52:38 +0000 2018,"@OmarHoryy @TeslaMotorsClub Seriously! Obviously, I’m not going to do an April Fool’s joke about going bankwupt if… https://t.co/jv3zCxKJsP",1354,123,1477,2018-04-02
1786,980876926830039041,Mon Apr 02 18:37:37 +0000 2018,"@TeslaMotorsClub Lot of respect for NTSB, but NHTSA regulates cars, not NTSB, which is an advisory body. Tesla rele… https://t.co/RStKMakag1",6004,419,6423,2018-04-02
1787,980647754555826176,Mon Apr 02 03:26:58 +0000 2018,RT @Teslarati: Tesla Model S navigates one of Vienna’s ‘crappiest’ roads on Autopilot https://t.co/C60brOxv5k https://t.co/CS08EwdgR1,0,911,911,2018-04-02
1788,980647734888681472,Mon Apr 02 03:26:54 +0000 2018,"@Teslarati @13ericralph31 @w00ki33 Oh yeah, forgot to mention it actually landed fine, just not on Mr Steven https://t.co/HckB2OkJ5L",8829,633,9462,2018-04-02
1789,980589463611916288,Sun Apr 01 23:35:21 +0000 2018,@TommyThornton What about this? https://t.co/s5zcMvzXC7,2903,162,3065,2018-04-01
1790,980585671218774017,Sun Apr 01 23:20:17 +0000 2018,@_iitzBrendon Elon University is a real place,3567,839,4406,2018-04-01
1791,980584035679289346,Sun Apr 01 23:13:47 +0000 2018,"RT @NASA: Tomorrow, a #Dragon atop a fiery @SpaceX rocket will deliver science that studies thunderstorms on Earth, space gardening, contro…",0,2509,2509,2018-04-01
1792,980569082838700033,Sun Apr 01 22:14:22 +0000 2018,@vreeman Coming soon to Tesla merch. Free shots in stores every April 1st.,7457,324,7781,2018-04-01
1793,980568382591328256,Sun Apr 01 22:11:35 +0000 2018,@AntVenom As you wish,3062,123,3185,2018-04-01
1794,980566785803018240,Sun Apr 01 22:05:14 +0000 2018,@peteWcarle It’s the best,2218,41,2259,2018-04-01
1795,980566116614291456,Sun Apr 01 22:02:34 +0000 2018,"Elon was found passed out against a Tesla Model 3, surrounded by ""Teslaquilla"" bottles, the tracks of dried tears s… https://t.co/qywhwwMHju",119161,20764,139925,2018-04-01
1796,980566103356194816,Sun Apr 01 22:02:31 +0000 2018,"There are many chapters of bankruptcy and, as critics so rightly pointed out, Tesla has them *all*, including Chapt… https://t.co/n3FlZiSBJY",47945,5141,53086,2018-04-01
1797,980566101124722688,Sun Apr 01 22:02:31 +0000 2018,"Tesla Goes Bankrupt
Palo Alto, California, April 1, 2018 -- Despite intense efforts to raise money, including a las… https://t.co/tXEEdimumA",130556,24430,154986,2018-04-01
1798,980518020358463489,Sun Apr 01 18:51:27 +0000 2018,Important news in a few hours …,86968,9108,96076,2018-04-01
1799,979904735972024321,Sat Mar 31 02:14:29 +0000 2018,Love seeing the scars of the rocket https://t.co/y5FQrLcV9B,70176,6485,76661,2018-03-31
1800,979896143604744193,Sat Mar 31 01:40:20 +0000 2018,"@vbagate Hopefully, actual video coming soon. Aiming to improve the link quality so it can be real-time.",1085,51,1136,2018-03-31
1801,979895766880841733,Sat Mar 31 01:38:51 +0000 2018,@SRodgerBock Everything’s better with fire,1167,71,1238,2018-03-31
1802,979893228160913408,Sat Mar 31 01:28:45 +0000 2018,Best music video art I’ve seen in a while https://t.co/F2E4zDZMyM,10585,1283,11868,2018-03-31
1803,979769569706307584,Fri Mar 30 17:17:23 +0000 2018,@BadAstronomer Tru drat,3548,168,3716,2018-03-30
1804,979764513233715200,Fri Mar 30 16:57:17 +0000 2018,"GPS guided parafoil twisted, so fairing impacted water at high speed. Air wake from fairing messing w parafoil stee… https://t.co/ycnNj9xJ6l",12858,799,13657,2018-03-30
1805,979730904087068672,Fri Mar 30 14:43:44 +0000 2018,Mr Steven is 5 mins away from being under the falling fairing (don’t have live video),14317,690,15007,2018-03-30
1806,979726332320915462,Fri Mar 30 14:25:34 +0000 2018,"Attempting recovery of fairing falling down from space (right now) with our boat, Mr Steven. It’s a giant steel &amp; w… https://t.co/Mexy7WWh3i",33155,2694,35849,2018-03-30
1807,979719752988942336,Fri Mar 30 13:59:26 +0000 2018,RT @SpaceX: ~60 minutes until Falcon 9 launch of Iridium-5. Launch webcast will go live about 15 minutes before liftoff → https://t.co/gtC3…,0,2129,2129,2018-03-30
1808,979539918086131713,Fri Mar 30 02:04:50 +0000 2018,"RT @nextspaceflight: CONFIRMED: #SpaceX ""fairing"" recovery vessel Mr. Steven is heading for YOUR MOM'S HOUSE. Yes, you read that right. @el…",0,2366,2366,2018-03-30
1809,979172121514520576,Thu Mar 29 01:43:20 +0000 2018,RT @Tesla: Model 3 is Popular Mechanics’ Car of the Year https://t.co/k0a9c4X6Wq,0,2586,2586,2018-03-29
1810,979038759646711808,Wed Mar 28 16:53:24 +0000 2018,RT @Toblerhaus: The Tesla Solar Roof is every bit as beautiful as I hoped. Hoping @PGE4Me allows us to turn it on very soon. I feel like we…,0,4932,4932,2018-03-28
1811,978913092443824128,Wed Mar 28 08:34:03 +0000 2018,"House party for the autonomous anarcho-syndicalist commune!! —— Peasant Woman: Well, how'd you… https://t.co/c85wR2xelx",8126,523,8649,2018-03-28
1812,978897638337794053,Wed Mar 28 07:32:38 +0000 2018,@Taraustralis @Drniallmc @BookHubPublish @1Cunionsandphey @brianmlucey @AstroVicnet @Armoured_Combat @GastroGays Yes. I forgot my sword.,666,36,702,2018-03-28
1813,978895981465960448,Wed Mar 28 07:26:03 +0000 2018,@Taraustralis @Drniallmc @BookHubPublish @1Cunionsandphey @brianmlucey @AstroVicnet @Armoured_Combat @GastroGays Du… https://t.co/QXKVHkpx1x,3020,144,3164,2018-03-28
1814,978895114524352513,Wed Mar 28 07:22:36 +0000 2018,"Turns out joking about being a “rock” star because of digging tunnels (through, uh, rock — hello??) is deeply underappreciated",107029,9377,116406,2018-03-28
1815,978665254329569280,Tue Mar 27 16:09:14 +0000 2018,"@asteroix Yes, you can upgrade hardware, although we also wrote software to accelerate rendering on old MCU. Coming… https://t.co/qVl58WAlUx",732,64,796,2018-03-27
1816,978502181069365249,Tue Mar 27 05:21:14 +0000 2018,"From my Mom: every time I use irony, I lose a friend",77215,9221,86436,2018-03-27
1817,978498291124981763,Tue Mar 27 05:05:46 +0000 2018,And they said I’d never be a rock star …,41565,4257,45822,2018-03-27
1818,978149655853744129,Mon Mar 26 06:00:25 +0000 2018,@safranye @DianaKFletcher @LeonsArcade Yes,673,17,690,2018-03-26
1819,978148065423970304,Mon Mar 26 05:54:06 +0000 2018,"@DianaKFletcher @LeonsArcade Uhh, it’s literally made of rock",1565,114,1679,2018-03-26
1820,978147162319085569,Mon Mar 26 05:50:31 +0000 2018,"@LeonsArcade Yeah, the boring bricks are interlocking with a precise surface finish, so two people could build the… https://t.co/eW6GD4ELr7",5092,346,5438,2018-03-26
1821,978143803830775810,Mon Mar 26 05:37:10 +0000 2018,@selberis Prob May,2646,75,2721,2018-03-26
1822,978142739463208961,Mon Mar 26 05:32:56 +0000 2018,@teslainventory Guaranteed to be Flamethrower-proof!,2727,80,2807,2018-03-26
1823,978142114339995648,Mon Mar 26 05:30:27 +0000 2018,"First kit set will be ancient Egypt — pyramids, Sphinx, temple of Horus, etc",28498,1894,30392,2018-03-26
1824,978140940241059840,Mon Mar 26 05:25:47 +0000 2018,New Boring Company merch coming soon. Lifesize LEGO-like interlocking bricks made from tunneling rock that you can… https://t.co/wr97P3OICT,74277,8904,83181,2018-03-26
1825,978132755740377088,Mon Mar 26 04:53:16 +0000 2018,"@aNichiporchik New nav starts rolling out this weekend. Should be considered a mature beta at first, so won’t be pe… https://t.co/IAa8OdVFhd",772,82,854,2018-03-26
1826,978056724950147072,Sun Mar 25 23:51:09 +0000 2018,https://t.co/C98mW0OPAF,30887,1752,32639,2018-03-25
1827,977720676722212864,Sun Mar 25 01:35:49 +0000 2018,@arstechnica @thepacketrat Shocker,11726,1018,12744,2018-03-25
1828,977660603975151616,Sat Mar 24 21:37:06 +0000 2018,@TeslaMotorsClub It’s not a political statement and I didn’t do this because someone dared me to do it. Just don’t… https://t.co/ZgzwRO26pK,30810,4142,34952,2018-03-24
1829,977653519078457344,Sat Mar 24 21:08:57 +0000 2018,@ElectrekCo I have just asked our team to slow down deliveries. It is clear that we are exceeding the local logisti… https://t.co/EFidMBWveR,10213,541,10754,2018-03-24
1830,977261549080297472,Fri Mar 23 19:11:24 +0000 2018,@tiggerl82 @VentureBeat @kharijohnson You’ll live,6260,478,6738,2018-03-23
1831,977258647641141248,Fri Mar 23 18:59:52 +0000 2018,@VentureBeat @kharijohnson We’ve never advertised with FB. None of my companies buy advertising or pay famous peopl… https://t.co/AhG6MbsXHP,47163,7487,54650,2018-03-23
1832,977236378105798656,Fri Mar 23 17:31:23 +0000 2018,"@martinapennisi @serdarsprofile @brianacton Instagram’s probably ok imo, so long as it stays fairly independent. I… https://t.co/9DZiBap562",5264,792,6056,2018-03-23
1833,977230073173393408,Fri Mar 23 17:06:20 +0000 2018,@themadstone Ok,7574,367,7941,2018-03-23
1834,977217002564546560,Fri Mar 23 16:14:23 +0000 2018,"@mcwm What, a troll, me!? How dare you, sir!",13269,1000,14269,2018-03-23
1835,977216799354728448,Fri Mar 23 16:13:35 +0000 2018,"@kerrymflynn Yeah, my fault for being an idiot. We did give them a free launch to make up for it and I think they had some insurance.",7793,568,8361,2018-03-23
1836,977216157080993793,Fri Mar 23 16:11:02 +0000 2018,@Bryson_M @RMac18 @serdarsprofile @brianacton Definitely. Looks lame anyway.,11335,1441,12776,2018-03-23
1837,977215954349211650,Fri Mar 23 16:10:13 +0000 2018,@aysegultelli @brianacton First time I’ve seen either. One on the left looks official. Will be gone soon.,2994,338,3332,2018-03-23
1838,977215713646583808,Fri Mar 23 16:09:16 +0000 2018,@sathish4vy @brianacton Maybe that word doesn’t mean what I think it does,974,50,1024,2018-03-23
1839,977214195698581504,Fri Mar 23 16:03:14 +0000 2018,@jiveDurkey @SpaceX @facebook Literally never seen it even once,7880,545,8425,2018-03-23
1840,977213864969256960,Fri Mar 23 16:01:55 +0000 2018,"@OfficeOfOMAR Yeah, it’s borderline. FB influence is slowly creeping in.",942,68,1010,2018-03-23
1841,977211923719598086,Fri Mar 23 15:54:12 +0000 2018,@serdarsprofile @brianacton I didn’t realize there was one. Will do.,18515,3173,21688,2018-03-23
1842,977210512021667840,Fri Mar 23 15:48:36 +0000 2018,@sathish4vy @brianacton Inconceivable! Who’d say a thing like that!?,1171,62,1233,2018-03-23
1843,977209817012977665,Fri Mar 23 15:45:50 +0000 2018,@brianacton What’s Facebook?,49479,13637,63116,2018-03-23
1844,977209516012986369,Fri Mar 23 15:44:38 +0000 2018,"@verge Wow, a whole week. Risky ...",8752,508,9260,2018-03-23
1845,977209059949494272,Fri Mar 23 15:42:50 +0000 2018,@SmileSimplify Umm...yes,801,25,826,2018-03-23
1846,977127504438747136,Fri Mar 23 10:18:45 +0000 2018,@benflux Yes,474,18,492,2018-03-23
1847,977113911475318784,Fri Mar 23 09:24:45 +0000 2018,@georgepaul82 I double-dare them to come back! Bring it ...,1404,52,1456,2018-03-23
1848,977041745979609088,Fri Mar 23 04:37:59 +0000 2018,No technology is too advanced for The Boring Company! https://t.co/r3EJYpcpkO,18756,1461,20217,2018-03-23
1849,976992482595545088,Fri Mar 23 01:22:14 +0000 2018,"@Lori_Garver @JeffBezos That said, Lori deserves a lot of credit for supporting competitive, commercial space launc… https://t.co/Dw2TcnPdHF",1028,78,1106,2018-03-23
1850,976774671516364800,Thu Mar 22 10:56:43 +0000 2018,"@Ron_sanes No real surface is perfect, but it did pull about 250,000 lbs of muck rail cars out of a tunnel https://t.co/wlKbLwd0f7",2504,366,2870,2018-03-22
1851,976771803044446208,Thu Mar 22 10:45:20 +0000 2018,"@tomkiss Probably mid next year before we are able to make RHD. Wish it could be sooner. Maybe try a Model S, used… https://t.co/FoKa1rMK0i",765,39,804,2018-03-22
1852,976769850663043073,Thu Mar 22 10:37:34 +0000 2018,@loganfeatures Sorry 🤗,996,22,1018,2018-03-22
1853,976769575466356736,Thu Mar 22 10:36:28 +0000 2018,"Model X pulls a 95,000 lb (15,000 above US road legal limit) semi truck on a pure snow surface https://t.co/AqmvgMXIYo",19499,2469,21968,2018-03-22
1854,976767301574787072,Thu Mar 22 10:27:26 +0000 2018,@bigyahu Thanks!,391,8,399,2018-03-22
1855,976767152173719552,Thu Mar 22 10:26:51 +0000 2018,@s3xy_ch Sounds like this canton has style!,925,43,968,2018-03-22
1856,976766285445910533,Thu Mar 22 10:23:24 +0000 2018,@xeokeri Ok,685,22,707,2018-03-22
1857,976766094630305792,Thu Mar 22 10:22:39 +0000 2018,@themodel3guy You’re welcome. Sorry for the delay. Only just got back from Gigafactory. Will be at our Fremont fact… https://t.co/rv1oinV1Pv,791,38,829,2018-03-22
1858,976763690585223168,Thu Mar 22 10:13:05 +0000 2018,Better to be in the Model X https://t.co/r0Tf79PSxE,12908,1201,14109,2018-03-22
1859,976761913131524098,Thu Mar 22 10:06:02 +0000 2018,"The Swiss police are smart. Electricity vs diesel &amp; maintenance more than make up for purchase price diff. Plus, th… https://t.co/OfgGdqSUpz",23642,3142,26784,2018-03-22
1860,976661622235152384,Thu Mar 22 03:27:30 +0000 2018,Maybe there should be 2 providers for Chicago advanced transit. Monopolies are so boring ... https://t.co/hXJBtKgbiB,23522,2865,26387,2018-03-22
1861,976418373457215488,Wed Mar 21 11:20:55 +0000 2018,Petra and Mars https://t.co/AFgsZVlImZ,8995,735,9730,2018-03-21
1862,976414452106055680,Wed Mar 21 11:05:20 +0000 2018,"@Lori_Garver @JeffBezos Lori, this is ridiculous. Creating a rocket company has to be one of the dumbest and hardes… https://t.co/pcd5YAl8Wo",29931,3789,33720,2018-03-21
1863,976168329097416704,Tue Mar 20 18:47:20 +0000 2018,@RanNatanzon @Tesla @Cortica This is completely false. Never even heard of Cortica. Just taking my kids on a Spring… https://t.co/t8IA4nlarQ,14811,858,15669,2018-03-20
1864,975919977495543808,Tue Mar 20 02:20:29 +0000 2018,Paid respects to Masada earlier today. Live free or die. https://t.co/RIfSVHRkDY,12284,1006,13290,2018-03-20
1865,975796402675703809,Mon Mar 19 18:09:26 +0000 2018,Learning how to pour flaming absinthe over a tower of glasses in a Jerusalem speakeasy.… https://t.co/kLFzl7SjH5,15523,1031,16554,2018-03-19
1866,975228272366759939,Sun Mar 18 04:31:53 +0000 2018,@IraEhrenpreis @Tesla Thanks for your support over all those years!,7202,154,7356,2018-03-18
1867,974356241119035392,Thu Mar 15 18:46:45 +0000 2018,"@TheOnion Your cruel taunts cut me deep. Deep. But, I love you too.",7981,444,8425,2018-03-15
1868,974355745993969664,Thu Mar 15 18:44:47 +0000 2018,@TheOnion Oh you guys ...,28855,1277,30132,2018-03-15
1869,974355452438888448,Thu Mar 15 18:43:37 +0000 2018,@timthetatman Yeah. I find it soothing.,9677,1404,11081,2018-03-15
1870,974048143871434752,Wed Mar 14 22:22:29 +0000 2018,@JeffreyWolff Yes,456,16,472,2018-03-14
1871,974035192565317632,Wed Mar 14 21:31:01 +0000 2018,"RT @NASA: Remembering Stephen Hawking, a renowned physicist and ambassador of science. His theories unlocked a universe of possibilities th…",0,150765,150765,2018-03-14
1872,973998998209011712,Wed Mar 14 19:07:11 +0000 2018,@AnubhavArora06 Good point,817,19,836,2018-03-14
1873,973972643190792193,Wed Mar 14 17:22:28 +0000 2018,"That’s the name of my new intergalactic media empire, exclamation point optional",31613,2161,33774,2018-03-14
1874,973860794679967745,Wed Mar 14 09:58:01 +0000 2018,@MaxF01234 @BleachTheLies Resist,2725,114,2839,2018-03-14
1875,973860151697457152,Wed Mar 14 09:55:28 +0000 2018,@BleachTheLies Thinkularity,4019,186,4205,2018-03-14
1876,973857445683462145,Wed Mar 14 09:44:43 +0000 2018,Thud!,47130,3863,50993,2018-03-14
1877,972996509477216256,Mon Mar 12 00:43:39 +0000 2018,@prof_wsoff Great idea!,479,22,501,2018-03-12
1878,972754606647365632,Sun Mar 11 08:42:25 +0000 2018,"My brother, Jonah and I are going to do a cover of My Little Buttercup from The Three Amigos. It will be terrible.… https://t.co/F3R19LbTWh",34539,3140,37679,2018-03-11
1879,972697639325233154,Sun Mar 11 04:56:03 +0000 2018,On the Westworld set with my bro @kimbal https://t.co/UNSB4vGp5O,13850,819,14669,2018-03-11
1880,972628124893671432,Sun Mar 11 00:19:50 +0000 2018,"Why Falcon Heavy &amp; Starman?

Life cannot just be about solving one sad problem after another. There need to be thin… https://t.co/yiipelSB2Q",103606,30986,134592,2018-03-11
1881,972553071845879809,Sat Mar 10 19:21:36 +0000 2018,@CBinsights Doesn’t make any sense. You can’t “take things that fail” &amp; make them work without creativity &amp; invention.,14050,1433,15483,2018-03-10
1882,972338813329534976,Sat Mar 10 05:10:12 +0000 2018,"@Advil No, it’s not",7648,1076,8724,2018-03-10
1883,972336214262013952,Sat Mar 10 04:59:53 +0000 2018,@dedubb4 None of the above,10016,336,10352,2018-03-10
1884,972335273462841344,Sat Mar 10 04:56:08 +0000 2018,Tunnels,22187,3465,25652,2018-03-10
1885,972248502762799104,Fri Mar 09 23:11:21 +0000 2018,@RodrigoEP01 Because blue,9448,713,10161,2018-03-09
1886,972248154354495488,Fri Mar 09 23:09:58 +0000 2018,"@2AvSagas I guess you could say it’s a 150 mph, underground, autonomous, electric bus that automatically switches b… https://t.co/zLFEX32KRG",10714,983,11697,2018-03-09
1887,972245615735222273,Fri Mar 09 22:59:52 +0000 2018,"Better video coming soon, but it would look a bit like this: https://t.co/C0iJPi8b4U",118224,31766,149990,2018-03-09
1888,972243992153739265,Fri Mar 09 22:53:25 +0000 2018,Boring Co urban loop system would have 1000’s of small stations the size of a single parking space that take you ve… https://t.co/3CU6W8QSw4,32916,3715,36631,2018-03-09
1889,972240946115915776,Fri Mar 09 22:41:19 +0000 2018,@Advil Definitely,999,34,1033,2018-03-09
1890,972235526848708608,Fri Mar 09 22:19:47 +0000 2018,"Will still transport cars, but only after all personalized mass transit needs are met. It’s a matter of courtesy &amp;… https://t.co/Jlg5Ll3hrN",42126,5503,47629,2018-03-09
1891,972233079342297088,Fri Mar 09 22:10:03 +0000 2018,Adjusting The Boring Company plan: all tunnels &amp; Hyperloop will prioritize pedestrians &amp; cyclists over cars,88210,12970,101180,2018-03-09
1892,972223971813818369,Fri Mar 09 21:33:52 +0000 2018,@kronayne Heavy sigh,5868,410,6278,2018-03-09
1893,972151775934365697,Fri Mar 09 16:46:59 +0000 2018,"@starlight_juice Talulah is in England, finishing her second novel. It’s about a future matriarchal society, with a twist.",1042,30,1072,2018-03-09
1894,972149891848798208,Fri Mar 09 16:39:30 +0000 2018,"Will be at SXSW Sat/Sun with Jonah &amp; Lisa, who created Westworld. Jonah made an incredible short reel of Falcon Hea… https://t.co/dg5kajWmCK",26392,2186,28578,2018-03-09
1895,972136022854135808,Fri Mar 09 15:44:23 +0000 2018,RT @TechCrunch: The @Tesla Model 3 is a love letter to the road (by @etherington) https://t.co/Nd9KXftYbJ https://t.co/qmfymUiaZa,0,1493,1493,2018-03-09
1896,971969114435563520,Fri Mar 09 04:41:09 +0000 2018,RT @KallieWinners: Some of the amazing Women in @Tesla that are paving the way to a more sustainable future.  #InternationalWomensDay2018 h…,0,1810,1810,2018-03-09
1897,971898600274870272,Fri Mar 09 00:00:57 +0000 2018,"@realDonaldTrump To be clear, I think a fair outcome for all is quite likely. China has already shown a willingness… https://t.co/6PiZWpe76d",4278,412,4690,2018-03-09
1898,971879393143406593,Thu Mar 08 22:44:38 +0000 2018,"RT @SpaceXJobs: From all the women at SpaceX who are helping to engineer the future of space exploration, happy International Women’s Day!…",0,9133,9133,2018-03-08
1899,971815058475921408,Thu Mar 08 18:29:00 +0000 2018,"@realDonaldTrump We raised this with the prior administration and nothing happened. Just want a fair outcome, ideal… https://t.co/qeN6Sv4xsW",8259,1161,9420,2018-03-08
1900,971814004887715840,Thu Mar 08 18:24:48 +0000 2018,"@realDonaldTrump I am against import duties in general, but the current rules make things very difficult. It’s like… https://t.co/YtlvwQFgnT",5167,818,5985,2018-03-08
1901,971812680594964480,Thu Mar 08 18:19:33 +0000 2018,"@realDonaldTrump Also, no US auto company is allowed to own even 50% of their own factory in China, but there are f… https://t.co/REXcsIZPRO",8974,2149,11123,2018-03-08
1902,971811614411276288,Thu Mar 08 18:15:18 +0000 2018,"@realDonaldTrump For example, an American car going to China pays 25% import duty, but a  Chinese car coming to the… https://t.co/f9aF7i8XY3",10925,2620,13545,2018-03-08
1903,971810418128691200,Thu Mar 08 18:10:33 +0000 2018,"@realDonaldTrump Do you think the US &amp; China should have equal &amp; fair rules for cars? Meaning, same import duties,… https://t.co/Up46rR8SJB",15381,1672,17053,2018-03-08
1904,971624496825159680,Thu Mar 08 05:51:46 +0000 2018,https://t.co/wJDmXrEuKi,46658,3280,49938,2018-03-08
1905,971618409187127296,Thu Mar 08 05:27:35 +0000 2018,https://t.co/pNElNTmcKf,174048,24230,198278,2018-03-08
1906,971550967018614784,Thu Mar 08 00:59:35 +0000 2018,"@verge Every time Alexa laughs, an angel dies, so thank goodness …",18680,1725,20405,2018-03-08
1907,971510290163499008,Wed Mar 07 22:17:57 +0000 2018,@ParkerMolloy Depends on what you mean by “doom”,903,60,963,2018-03-07
1908,971466308855332864,Wed Mar 07 19:23:11 +0000 2018,"First production cargo trip of the Tesla Semi heavy duty truck, carrying battery packs from the… https://t.co/6fIMYGfKw1",34613,4623,39236,2018-03-07
1909,971459140890411008,Wed Mar 07 18:54:42 +0000 2018,@FutureCars360 @Tesla Will have Model X do a cover of Happy Birthday by Marilyn Monroe https://t.co/8TaiBF6HLs,467,30,497,2018-03-07
1910,971307576959885312,Wed Mar 07 08:52:27 +0000 2018,"@jeremyburge Literally, if you type “jazz hands”, iOS shows this emoji 🤗",4805,220,5025,2018-03-07
1911,971224396890124288,Wed Mar 07 03:21:55 +0000 2018,I just realized there is a jazz hands emoji 🤗,150523,16500,167023,2018-03-07
1912,971106671631130624,Tue Mar 06 19:34:07 +0000 2018,"@mattfeinman If there is anyone in the third row, turn off air recirculation. Third row cooling happens by air ente… https://t.co/7XI4A2W5rr",6041,195,6236,2018-03-06
1913,970914681069039617,Tue Mar 06 06:51:13 +0000 2018,"@SpaceX Very proud of the SpaceX team! Can’t believe it’s been fifty Falcon 9 launches already. Just ten years ago,… https://t.co/Ri6hWnrGpY",32473,3465,35938,2018-03-06
1914,970772377201070080,Mon Mar 05 21:25:45 +0000 2018,RT @SpaceX: Falcon 9 and Hispasat 30W-6 are vertical on Space Launch Complex 40 at Cape Canaveral Air Force Station in Florida. Weather is…,0,3082,3082,2018-03-05
1915,970747812311740416,Mon Mar 05 19:48:08 +0000 2018,"Falcon 9 flight 50 launches tonight, carrying Hispasat for Spain. At 6 metric tons and almost the size of a city bu… https://t.co/ACEhpZfQTY",70694,10496,81190,2018-03-05
1916,970192640913301504,Sun Mar 04 07:02:05 +0000 2018,"@keithbigelow Very sensible summary of supersonic flight. Obvious answer is to fly high, which gives low drag &amp; low… https://t.co/krmKkBSTNf",9194,498,9692,2018-03-04
1917,970099121599074304,Sun Mar 04 00:50:28 +0000 2018,@simonhackett @ToddBourne @Tesla Good points. Will add to feature list.,657,30,687,2018-03-04
1918,970096186806878208,Sun Mar 04 00:38:49 +0000 2018,"@simonhackett @ToddBourne @Tesla Yeah, that should improve soon. Software team has been buried in Model 3 bringup a… https://t.co/dqxhRaK5ff",627,35,662,2018-03-04
1919,970088614183845888,Sun Mar 04 00:08:43 +0000 2018,@ToddBourne @Tesla Almost done,8543,228,8771,2018-03-04
1920,970067019012784128,Sat Mar 03 22:42:54 +0000 2018,"Deep in the hole with my boring machine. Sometimes when we touch, the honesty’s too much ... https://t.co/pl6ap14tAB",38670,3122,41792,2018-03-03
1921,968707151815376897,Wed Feb 28 04:39:17 +0000 2018,@Pewwer42 Probably about a tenth of the cost and a fifth of the time,820,62,882,2018-02-28
1922,968614419784613888,Tue Feb 27 22:30:48 +0000 2018,"Want to clarify that as individuals, the people responsible for the high costs &amp; long timelines are almost all well… https://t.co/3rRSmzpkKa",13538,1115,14653,2018-02-27
1923,968611860407713793,Tue Feb 27 22:20:38 +0000 2018,Higher safety &amp; environmental requirements &amp; labor costs explain only a small part of the difference. True root cau… https://t.co/SPv5tY9McI,17346,2112,19458,2018-02-27
1924,968609579197022208,Tue Feb 27 22:11:34 +0000 2018,And New York https://t.co/gKuzKMLYS1,9303,979,10282,2018-02-27
1925,968609334203576320,Tue Feb 27 22:10:35 +0000 2018,And we are even worse than that in California https://t.co/WIKetQShMP,8511,898,9409,2018-02-27
1926,968608879914270721,Tue Feb 27 22:08:47 +0000 2018,China’s progress in advanced infrastructure is more than 100 times faster than the US https://t.co/fcqGIK78RY,42729,10947,53676,2018-02-27
1927,968563317810847744,Tue Feb 27 19:07:44 +0000 2018,RT @decodethefirm: Motown eye-opener: The @DetroitNews fetes glowing @Tesla Model 3 review with P1 above-the-fold treatment... https://t.co…,0,690,690,2018-02-27
1928,968560525088055296,Tue Feb 27 18:56:38 +0000 2018,"@cdelancray @sapinker @WIRED Wow, if even Pinker doesn’t understand the difference between functional/narrow AI (eg… https://t.co/lRzCZSvz9g",18704,2236,20940,2018-02-27
1929,967728299282595840,Sun Feb 25 11:49:40 +0000 2018,@cheresh @andrestaltz End-to-end encryption encoded at firmware level. Unlikely to be hacked w current computing te… https://t.co/njB5PApTg3,1698,178,1876,2018-02-25
1930,967712110661615616,Sun Feb 25 10:45:21 +0000 2018,@andrestaltz Will be simpler than IPv6 and have tiny packet overhead. Definitely peer-to-peer.,9160,666,9826,2018-02-25
1931,967238652685303809,Sat Feb 24 03:23:59 +0000 2018,RT @Teslarati: SpaceX’s recovered fairing spotted sailing into port on Mr. Steven - https://t.co/r64KYSQAo7 https://t.co/2ivCZgfrN1,0,1170,1170,2018-02-24
1932,967238527418167296,Sat Feb 24 03:23:30 +0000 2018,@ElectrekCo @TeslaRoadTrip Am feeling optimistic about beating the Semi specs announced at the unveiling for the sa… https://t.co/8pmhbx0Yno,16823,1062,17885,2018-02-24
1933,967238120709152770,Sat Feb 24 03:21:53 +0000 2018,"RT @ElectrekCo: A Tesla Semi electric truck could save us ‘tens of thousands of dollars a year’, says DHL https://t.co/vcXmXtzoCE https://t…",0,2673,2673,2018-02-24
1934,966707388181970944,Thu Feb 22 16:12:56 +0000 2018,@DMC_Ryan Can someone please do that!? I would def go.,5216,230,5446,2018-02-22
1935,966707038095986688,Thu Feb 22 16:11:33 +0000 2018,"That was a DM, right?",37748,2442,40190,2018-02-22
1936,966706924124188672,Thu Feb 22 16:11:05 +0000 2018,"Don’t tell anyone, but the wifi password is “martians”",52459,7860,60319,2018-02-22
1937,966706193560305664,Thu Feb 22 16:08:11 +0000 2018,Tintin A &amp; B will attempt to beam “hello world” in about 22 hours when they pass near LA,43946,5079,49025,2018-02-22
1938,966703261699854336,Thu Feb 22 15:56:32 +0000 2018,"First two Starlink demo satellites, called Tintin A &amp; B, deployed and communicating to Earth stations https://t.co/TfI53wHEtz",41967,7759,49726,2018-02-22
1939,966698367173693440,Thu Feb 22 15:37:05 +0000 2018,"Falcon fairing half as seen from our catcher’s mitt in boat form, Mr. Steven. No apparent damage… https://t.co/48ZGaUwQOY",12621,1450,14071,2018-02-22
1940,966695975132610560,Thu Feb 22 15:27:35 +0000 2018,@DMOberhaus About a month,946,32,978,2018-02-22
1941,966694661480841217,Thu Feb 22 15:22:22 +0000 2018,"@minhazLive This was an older version booster, so no recovery attempted",755,30,785,2018-02-22
1942,966692641533390848,Thu Feb 22 15:14:20 +0000 2018,"Missed by a few hundred meters, but fairing landed intact in water. Should be able catch it with slightly bigger ch… https://t.co/D2RjG13Rpr",21253,1532,22785,2018-02-22
1943,966682281443143680,Thu Feb 22 14:33:10 +0000 2018,RT @SpaceX: Successful deployment of PAZ satellite to low-Earth orbit confirmed. https://t.co/xOEuyaFrcZ,0,4862,4862,2018-02-22
1944,966682218411143169,Thu Feb 22 14:32:55 +0000 2018,Made it back from space and fairing parafoil just deployed. Now trying to catch it ...,35613,2752,38365,2018-02-22
1945,966676057784020992,Thu Feb 22 14:08:26 +0000 2018,Going to try to catch the giant fairing (nosecone) of Falcon 9 as it falls back from space at… https://t.co/CVS2PoaJah,20831,2727,23558,2018-02-22
1946,966627437458026497,Thu Feb 22 10:55:14 +0000 2018,"@journoanirban @Uber @dkhos @HyperloopOne @hyperlooptt @vccircle @vccstartups If you love drones above your house,… https://t.co/57GJSwh4pX",20576,2267,22843,2018-02-22
1947,966602470431473664,Thu Feb 22 09:16:02 +0000 2018,"@DeadlyBananas @MichaelAVaughn Not sure. I let @jack know, but it’s still going. I literally own zero cryptocurrenc… https://t.co/915Uq5prJT",1237,138,1375,2018-02-22
1948,966419298049703936,Wed Feb 21 21:08:10 +0000 2018,@edeggermont That’s just random,413,23,436,2018-02-21
1949,966418678160924672,Wed Feb 21 21:05:42 +0000 2018,"If anyone is curious, the name was inspired by The Fault in Our Stars",24004,1749,25753,2018-02-21
1950,966379138947809280,Wed Feb 21 18:28:35 +0000 2018,RT @OpenAI: OpenAI Supporters: https://t.co/2IQa3iGjk2,0,667,667,2018-02-21
1951,966313683633623041,Wed Feb 21 14:08:30 +0000 2018,"High altitude wind shear data shows a probable 2% load exceedance. Small, but better to be paranoid. Postponing lau… https://t.co/dzuOlZIzs3",16983,1286,18269,2018-02-21
1952,966298034978959361,Wed Feb 21 13:06:19 +0000 2018,"Today’s Falcon launch carries 2 SpaceX test satellites for global broadband. If successful, Starlink constellation will serve least served.",74443,10974,85417,2018-02-21
1953,966296921370386432,Wed Feb 21 13:01:53 +0000 2018,@lorengrush @T28058389 @VP @blueorigin @ulalaunch @SpaceX @Erdayastronaut @SciGuySpace Strange though. Delta IV Hea… https://t.co/b5ildBV6pf,807,72,879,2018-02-21
1954,965769366422798337,Tue Feb 20 02:05:34 +0000 2018,@angilly I don’t get the little ship thing. You can’t show up at Mars in something the size of a rowboat. What if t… https://t.co/Aj0zv8Lwdf,66637,10306,76943,2018-02-20
1955,965297598054637568,Sun Feb 18 18:50:56 +0000 2018,"I’m sure it’s parked around here somewhere …
https://t.co/cq4LEhu4qD",67220,12755,79975,2018-02-18
1956,964866320197038080,Sat Feb 17 14:17:11 +0000 2018,With Asimov’s Foundation Series etched in glass in the glovebox. Zeroth law …,11521,765,12286,2018-02-17
1957,964751491885076480,Sat Feb 17 06:40:54 +0000 2018,My new toaster https://t.co/1pw7xJeLpB,41029,3493,44522,2018-02-17
1958,964296857395478529,Fri Feb 16 00:34:21 +0000 2018,@Teslarati Adding software feature to open glovebox automatically when car comes to a stop after a crash. Will look… https://t.co/OlM3sV2Ku9,15517,858,16375,2018-02-16
1959,963145162397396992,Mon Feb 12 20:17:55 +0000 2018,@doug_ellison @dsfpspacefl1ght Found the source of the problem. The NASA database has the Falcon Block 1 performanc… https://t.co/ksGp65AE8P,1204,90,1294,2018-02-12
1960,963107229523038211,Mon Feb 12 17:47:11 +0000 2018,@kerrbones @nextspaceflight Not enough ignition fluid to light the outer two engines after several three engine rel… https://t.co/X0vvdL6ISs,1482,158,1640,2018-02-12
1961,963104633639002112,Mon Feb 12 17:36:52 +0000 2018,"@EmreKelly @nova_road @nextspaceflight East, to support high flight rates for F9 and dual ocean landings for FH side boosters",989,74,1063,2018-02-12
1962,963104452767924224,Mon Feb 12 17:36:09 +0000 2018,@octagrabber @nova_road @nextspaceflight No,578,20,598,2018-02-12
1963,963103592881168384,Mon Feb 12 17:32:44 +0000 2018,@nova_road @nextspaceflight A Shortfall of Gravitas,1779,210,1989,2018-02-12
1964,963102131421982721,Mon Feb 12 17:26:56 +0000 2018,@nextspaceflight A third is under construction,1153,105,1258,2018-02-12
1965,963095860060934144,Mon Feb 12 17:02:01 +0000 2018,@DJSnM @doug_ellison @dsfpspacefl1ght Under consideration. We’ve already stretched the upper stage once. Easiest pa… https://t.co/m9mJunwoZY,1321,112,1433,2018-02-12
1966,963094533830426624,Mon Feb 12 16:56:44 +0000 2018,@DavideDF_ @doug_ellison @dsfpspacefl1ght Side boosters landing on droneships &amp; center expended is only ~10% perfor… https://t.co/Wx1Q0nS5dr,778,92,870,2018-02-12
1967,963093040100384769,Mon Feb 12 16:50:48 +0000 2018,@doug_ellison @DavideDF_ @dsfpspacefl1ght https://t.co/LijrUMuJDq,467,23,490,2018-02-12
1968,963092560867504128,Mon Feb 12 16:48:54 +0000 2018,@AngryPackOMeese @dlxinorbit @doug_ellison @dsfpspacefl1ght Of course :),1110,42,1152,2018-02-12
1969,963092110994886656,Mon Feb 12 16:47:07 +0000 2018,"@AngryPackOMeese @dlxinorbit @doug_ellison @dsfpspacefl1ght Maybe that plan works out, but I will seriously eat my… https://t.co/DgYpjAzu8D",1807,273,2080,2018-02-12
1970,963090657119055872,Mon Feb 12 16:41:20 +0000 2018,"@dlxinorbit @doug_ellison @dsfpspacefl1ght That was three years ago, before ULA cancelled all medium versions of De… https://t.co/QLYnsUPw6M",794,47,841,2018-02-12
1971,963087975004319746,Mon Feb 12 16:30:41 +0000 2018,@doug_ellison @dsfpspacefl1ght Both exhaust velocity (Isp) and mass ratio drive the rocket equation. Also thrust/ma… https://t.co/Wonv8GRZWq,810,69,879,2018-02-12
1972,963076231921938432,Mon Feb 12 15:44:01 +0000 2018,@doug_ellison @dsfpspacefl1ght The performance numbers in this database are not accurate. In process of being fixed… https://t.co/7qTC2LQqNN,1659,208,1867,2018-02-12
1973,962805302927257600,Sun Feb 11 21:47:26 +0000 2018,Love and Rockets https://t.co/VnnFXb1Iig,38040,3261,41301,2018-02-11
1974,962750602223566848,Sun Feb 11 18:10:05 +0000 2018,"Now, if I can just figure out how to attach those to a really big shark ...",59927,6047,65974,2018-02-11
1975,962735351713411072,Sun Feb 11 17:09:29 +0000 2018,Falcon Heavy engine plumes look like giant laser beams in this photo by rocketphotography https://t.co/d1RKdPTNj5,59736,6473,66209,2018-02-11
1976,961359174230773765,Wed Feb 07 22:01:02 +0000 2018,Last pic of Starman in Roadster on its journey to Mars orbit and then the Asteroid Belt https://t.co/IWSjRyTr8V,106545,23211,129756,2018-02-07
1977,961083704230674438,Wed Feb 07 03:46:25 +0000 2018,Third burn successful. Exceeded Mars orbit and kept going to the Asteroid Belt. https://t.co/bKhRN73WHF,193504,36929,230433,2018-02-07
1978,961079361234497537,Wed Feb 07 03:29:10 +0000 2018,@realDonaldTrump @SpaceX @NASA Thank you on behalf of SpaceX. An exciting future lies ahead!,47293,3802,51095,2018-02-07
1979,961070320106041346,Wed Feb 07 02:53:14 +0000 2018,@SamHarrisOrg @SpaceX We’re doing ok for a bunch of monkeys. Humanity rocks!,33536,4091,37627,2018-02-07
1980,961070013108060160,Wed Feb 07 02:52:01 +0000 2018,@VP @SpaceX Thank you on behalf of SpaceX,7232,349,7581,2018-02-07
1981,961036779498418178,Wed Feb 07 00:39:58 +0000 2018,RT @TheFavoritist: Ohh my god @ChrisG_NSF &amp; @NASASpaceflight! Remote number one from Falcon Heavy! https://t.co/aj4ly8Cr5r,0,9581,9581,2018-02-07
1982,961025203382841344,Tue Feb 06 23:53:58 +0000 2018,On the rocket LZ https://t.co/UyiNd2fmi5,21671,2305,23976,2018-02-06
1983,961006748214718466,Tue Feb 06 22:40:38 +0000 2018,Printed on the circuit board of a car in deep space https://t.co/8ZMJVUs4W1,74788,16167,90955,2018-02-06
1984,960998900243902466,Tue Feb 06 22:09:26 +0000 2018,Currently over Australia 🇦🇺 https://t.co/HAya3E6OEJ,186661,43374,230035,2018-02-06
1985,960994034960416768,Tue Feb 06 21:50:06 +0000 2018,Live view of Starman https://t.co/gvSlztlE6l,73871,25387,99258,2018-02-06
1986,960992715579125760,Tue Feb 06 21:44:52 +0000 2018,"View from SpaceX Launch Control. Apparently, there is a car in orbit around Earth. https://t.co/QljN2VnL1O",481000,171854,652854,2018-02-06
1987,960988527159795712,Tue Feb 06 21:28:13 +0000 2018,"Upper stage restart nominal, apogee raised to 7000 km. Will spend 5 hours getting zapped in Van Allen belts &amp; then… https://t.co/XxL0fQhGZa",106920,14887,121807,2018-02-06
1988,960987195531198466,Tue Feb 06 21:22:56 +0000 2018,Rocket LZ 1 and 2 https://t.co/gckyKKIK4I,30129,3884,34013,2018-02-06
1989,960982935175245824,Tue Feb 06 21:06:00 +0000 2018,RT @SpaceX: Falcon Heavy side cores have landed at SpaceX’s Landing Zones 1 and 2. https://t.co/oMBqizqnpI,0,75642,75642,2018-02-06
1990,960975644644593664,Tue Feb 06 20:37:02 +0000 2018,Camera views from inside the payload fairing #FalconHeavy https://t.co/vQaz2yJ5yY,43432,8594,52026,2018-02-06
1991,960949244982018049,Tue Feb 06 18:52:08 +0000 2018,Launch auto-sequence initiated (aka the holy mouse-click) for 3:45 liftoff #FalconHeavy,60171,10445,70616,2018-02-06
1992,960921700153135104,Tue Feb 06 17:02:41 +0000 2018,Upper atmosphere winds currently 20% above max allowable load. Holding for an hour to allow winds to diminish. #FalconHeavy,34143,3852,37995,2018-02-06
1993,960915618865274880,Tue Feb 06 16:38:31 +0000 2018,Flight profile #FalconHeavy #SpaceX https://t.co/LlfWXqUaLP,85927,24883,110810,2018-02-06
1994,960914210397085696,Tue Feb 06 16:32:55 +0000 2018,Live webcast of the launch at https://t.co/bDd3GxQXMC,24613,7850,32463,2018-02-06
1995,960905835118505984,Tue Feb 06 15:59:38 +0000 2018,About 2.5 hours to T-0 for Falcon Heavy. Watch sim for highlight reel of what we hope happens. Car actually takes 6… https://t.co/h6IVoJVr6d,32061,7331,39392,2018-02-06
1996,960589757519663105,Mon Feb 05 19:03:39 +0000 2018,All systems remain green for launch at 1:30pm EST tomorrow,30763,4155,34918,2018-02-05
1997,960579820487954432,Mon Feb 05 18:24:10 +0000 2018,Falcon Heavy sends a car to Mars https://t.co/Y7uBtU6Mt2,55970,16096,72066,2018-02-05
1998,960550111632875525,Mon Feb 05 16:26:07 +0000 2018,@JeffBezos @SpaceX @blueorigin Thanks 😘,21940,1617,23557,2018-02-05
1999,960401102465269760,Mon Feb 05 06:34:00 +0000 2018,Regular departures ... https://t.co/5GM9CbMewd,39676,5244,44920,2018-02-05
2000,960400928225546241,Mon Feb 05 06:33:19 +0000 2018,https://t.co/nhB3gd0Gm6,76632,12494,89126,2018-02-05
2001,960390661211021312,Mon Feb 05 05:52:31 +0000 2018,Starman in Red Roadster https://t.co/ou88RVHZ1Z,15989,2283,18272,2018-02-05
2002,960366347971592192,Mon Feb 05 04:15:54 +0000 2018,Florida time,15235,870,16105,2018-02-05
2003,960366295362494464,Mon Feb 05 04:15:42 +0000 2018,Falcon Heavy remains go for launch at 1:30pm on Tuesday,44227,6957,51184,2018-02-05
2004,960310814908526594,Mon Feb 05 00:35:14 +0000 2018,Mars Awaits https://t.co/ZDo1pjT6q4,18240,2271,20511,2018-02-05
2005,960233035516932096,Sun Feb 04 19:26:10 +0000 2018,Pale blue dot https://t.co/KZj3I55EYl,29816,6753,36569,2018-02-04
2006,960196781081415680,Sun Feb 04 17:02:06 +0000 2018,"RT @physorg_com: Tesla, Australia to turn 50,000 homes into #power generators https://t.co/ng7C2wc06C",0,2674,2674,2018-02-04
2007,959902950964453376,Sat Feb 03 21:34:32 +0000 2018,Falcon Heavy launch simulation almost ready. Will be set to Bowie’s Life on Mars.,65021,7220,72241,2018-02-03
2008,959632581456113664,Sat Feb 03 03:40:11 +0000 2018,Customs problem solved! https://t.co/6D0Fbm8NFI,95430,14010,109440,2018-02-03
2009,959585626071842817,Sat Feb 03 00:33:36 +0000 2018,Or maybe “Temperature Enhancement Device”,113349,11387,124736,2018-02-03
2010,959555569953660928,Fri Feb 02 22:34:10 +0000 2018,"Apparently, some customs agencies are saying they won’t allow shipment of anything called a “Flamethrower”. To solv… https://t.co/OCtjvdXo95",381935,76869,458804,2018-02-02
2011,959482581451329536,Fri Feb 02 17:44:08 +0000 2018,"@TheTeslaShow Early access build and especially Dev build are feature-rich, but the features aren’t reliable enough yet",1664,53,1717,2018-02-02
2012,959481246710550528,Fri Feb 02 17:38:50 +0000 2018,@mrvergona Release candidate in final testing phase,536,29,565,2018-02-02
2013,959475866785820674,Fri Feb 02 17:17:27 +0000 2018,@AdamyanMichael No,342,15,357,2018-02-02
2014,959282790599557120,Fri Feb 02 04:30:14 +0000 2018,@TheEnderCobra I think we’ve figured it out,704,35,739,2018-02-02
2015,959041727758614528,Thu Feb 01 12:32:20 +0000 2018,@shannonNullCode Yes,1008,16,1024,2018-02-01
2016,959039217010491392,Thu Feb 01 12:22:22 +0000 2018,"Small detail, but each one will come with a serial number from 1 to 20,000 https://t.co/ZBYEYO6zqu",33294,2128,35422,2018-02-01
2017,958937357884973057,Thu Feb 01 05:37:36 +0000 2018,@AndrewGHobden A snowthrower would be really fun,8588,418,9006,2018-02-01
2018,958932755194167296,Thu Feb 01 05:19:19 +0000 2018,All flamethrowers will ship with a complimentary boring fire extinguisher,122040,13157,135197,2018-02-01
2019,958931799391924224,Thu Feb 01 05:15:31 +0000 2018,Flamethrowers sold out,154636,20587,175223,2018-02-01
2020,958872914278821893,Thu Feb 01 01:21:32 +0000 2018,@chandlerriggs @TheWalkingDead Of course,1514,67,1581,2018-02-01
2021,958848287628406784,Wed Jan 31 23:43:40 +0000 2018,@almeidagoncalo Yes,1643,37,1680,2018-01-31
2022,958847818583584768,Wed Jan 31 23:41:49 +0000 2018,"This rocket was meant to test very high retrothrust landing in water so it didn’t hurt the droneship, but amazingly… https://t.co/wAIBtlLyTz",50902,5994,56896,2018-01-31
2023,958845994984030208,Wed Jan 31 23:34:34 +0000 2018,"@omaruddin @stevewoz @Tesla @businessinsider Woz is a lovable, fuzzy bear 🐻",4128,304,4432,2018-01-31
2024,958845290022289408,Wed Jan 31 23:31:46 +0000 2018,@TheWalkingDead @chandlerriggs From the world’s leading experts in zombie defense,10881,704,11585,2018-01-31
2025,958825021098491904,Wed Jan 31 22:11:13 +0000 2018,@SpaceX Now that’s a real flamethrower …,40382,2909,43291,2018-01-31
2026,958824754596556800,Wed Jan 31 22:10:10 +0000 2018,RT @SpaceX: Successful deployment of GovSat-1 to a Geostationary Transfer Orbit confirmed. https://t.co/0D3h7hR7YF,0,1850,1850,2018-01-31
2027,958802580137627648,Wed Jan 31 20:42:03 +0000 2018,RT @SpaceX: T-60 minutes until Falcon 9 launch of GovSat-1. Launch webcast will go live about 15 minutes before liftoff → https://t.co/gtC3…,0,1599,1599,2018-01-31
2028,958568634917556224,Wed Jan 31 05:12:26 +0000 2018,https://t.co/LYJOL0T7sC,24683,3455,28138,2018-01-31
2029,958500867832975361,Wed Jan 31 00:43:09 +0000 2018,Falcon Heavy in foreground on Launch Complex 39A and Falcon 9 in background on 40 https://t.co/GiZL3SSE4A,16958,2176,19134,2018-01-31
2030,958371267203145729,Tue Jan 30 16:08:10 +0000 2018,15k,19165,748,19913,2018-01-30
2031,958083496370565120,Mon Jan 29 21:04:40 +0000 2018,@SunDogz ~3k,1195,25,1220,2018-01-29
2032,958082901987360769,Mon Jan 29 21:02:18 +0000 2018,@TheOnion So hard to keep future product releases secret,46967,5490,52457,2018-01-29
2033,958081411470131200,Mon Jan 29 20:56:23 +0000 2018,10k,20430,731,21161,2018-01-29
2034,958047422797643776,Mon Jan 29 18:41:19 +0000 2018,"@HarisCelic For sure, and it keeps you warm at the same time",4123,120,4243,2018-01-29
2035,958044440085409792,Mon Jan 29 18:29:28 +0000 2018,@JosephHuberman @Tesla Coming soon,458,10,468,2018-01-29
2036,957790484981719040,Mon Jan 29 01:40:21 +0000 2018,@DuvalMagic Sure,4307,142,4449,2018-01-29
2037,957788568457367552,Mon Jan 29 01:32:44 +0000 2018,@JeremyHeitman Sentience is overrated,2612,189,2801,2018-01-29
2038,957787361630236672,Mon Jan 29 01:27:56 +0000 2018,"But wait, there’s more: the flamethrower is sentient, its safe word is “cryptocurrency” and it comes with a free blockchain",116624,18478,135102,2018-01-29
2039,957708671219245061,Sun Jan 28 20:15:15 +0000 2018,@jlgolson Ok,650,22,672,2018-01-28
2040,957605497338605568,Sun Jan 28 13:25:16 +0000 2018,@andressa_ojeda @franke @boringcompany Hmm ... portal gun. Now that would be interesting.,3404,293,3697,2018-01-28
2041,957503604750823425,Sun Jan 28 06:40:23 +0000 2018,You’d need millions of zombies for a so-called “apocalypse” anyway. Where would I even get a factory big enough to make so many!?,118645,16069,134714,2018-01-28
2042,957494364028071936,Sun Jan 28 06:03:40 +0000 2018,The rumor that I’m secretly creating a zombie apocalypse to generate demand for flamethrowers is completely false,380695,100273,480968,2018-01-28
2043,957493532599640066,Sun Jan 28 06:00:22 +0000 2018,@franke @boringcompany Good thing you didn’t ask about the Freezegun ...,854,41,895,2018-01-28
2044,957493529244086273,Sun Jan 28 06:00:21 +0000 2018,@franke @boringcompany Hmmm,3226,100,3326,2018-01-28
2045,957476434800386053,Sun Jan 28 04:52:25 +0000 2018,Unless you like fun,97341,15020,112361,2018-01-28
2046,957469890473938950,Sun Jan 28 04:26:25 +0000 2018,"Obviously, a flamethrower is a super terrible idea. Definitely don’t buy one.",118176,19996,138172,2018-01-28
2047,957450070407852032,Sun Jan 28 03:07:40 +0000 2018,"1,000 ordered already, only 19,000 left!",44493,2512,47005,2018-01-28
2048,957441956874919936,Sun Jan 28 02:35:25 +0000 2018,"When the zombie apocalypse happens, you’ll be glad you bought a flamethrower. Works against hordes of the undead or your money back!",145770,28328,174098,2018-01-28
2049,957426074467618818,Sun Jan 28 01:32:18 +0000 2018,Don’t do this https://t.co/e0q6ax60k5,19914,3550,23464,2018-01-28
2050,957421513367416832,Sun Jan 28 01:14:11 +0000 2018,@MKBHD ATF says any flamethrower with a flame shorter than 10 ft is A-ok. Our design is max fun for least danger. I… https://t.co/sAp9NUdNzf,9491,771,10262,2018-01-28
2051,957416875826262016,Sun Jan 28 00:55:45 +0000 2018,Great for roasting nuts 🔥 🥜 https://t.co/MGmkSJhIyx,13841,1362,15203,2018-01-28
2052,957414748881997825,Sun Jan 28 00:47:18 +0000 2018,"The Boring Company flamethrower guaranteed to liven up any party! 
https://t.co/n2FiZimJia",41809,11079,52888,2018-01-28
2053,957413581020114944,Sun Jan 28 00:42:40 +0000 2018,Say hello to my little friend … https://t.co/OYg4qhF4Ea,14080,1618,15698,2018-01-28
2054,957361443023695872,Sat Jan 27 21:15:29 +0000 2018,Aiming for first flight of Falcon Heavy on Feb 6 from Apollo launchpad 39A at Cape Kennedy. Easy viewing from the public causeway.,60464,11800,72264,2018-01-27
2055,956246054432751616,Wed Jan 24 19:23:20 +0000 2018,"RT @nova_road: My raw video of the #SpaceX Falcon Heavy static-fire at Kennedy Space Center. Come for the cloud plumes, stay for the sound.…",0,4463,4463,2018-01-24
2056,956233892637286400,Wed Jan 24 18:35:00 +0000 2018,Falcon Heavy hold-down firing this morning was good. Generated quite a thunderhead of steam. Launching in a week or… https://t.co/2e6EEIKZw4,87326,14766,102092,2018-01-24
2057,954110572315918337,Thu Jan 18 21:57:41 +0000 2018,RT @business: Alibaba's artificial intelligence has scored better than humans in a Stanford reading test https://t.co/BIQuU3vhJ1 https://t.…,0,1980,1980,2018-01-18
2058,954074142835294208,Thu Jan 18 19:32:56 +0000 2018,@sallyshin Check https://t.co/Il3CWSTPXR for updates,1214,51,1265,2018-01-18
2059,952964012009971712,Mon Jan 15 18:01:40 +0000 2018,"RT @AnthonyLacavera: Safe #AI for all, @elonmusk's @OpenAI is looking to expand its team &amp; continue on its goal of creating AI that does no…",0,1276,1276,2018-01-15
2060,952753984896315392,Mon Jan 15 04:07:05 +0000 2018,@Davidburrusdds Done,564,26,590,2018-01-15
2061,952750646406426624,Mon Jan 15 03:53:50 +0000 2018,@thenosyt Definitely. You will be able to do pretty much anything via voice command. Software team is focused on co… https://t.co/Jt5hQoKqGC,688,82,770,2018-01-15
2062,952049059291803648,Sat Jan 13 05:25:58 +0000 2018,@DanielleFong @YoungTreeGrower @TylerDoor @ID_AA_Carmack There aren’t even good normal parties in Silicon Valley!,961,112,1073,2018-01-13
2063,951893894605586432,Fri Jan 12 19:09:24 +0000 2018,"@ID_AA_Carmack @DanielleFong Actually, you can upgrade the battery pack for a huge improvement in range and some im… https://t.co/qaSM83VkwK",546,44,590,2018-01-12
2064,950798675579609088,Tue Jan 09 18:37:23 +0000 2018,@Mister_Millard @Tesla That sounds cool. Will do.,1175,57,1232,2018-01-09
2065,950600363630931968,Tue Jan 09 05:29:22 +0000 2018,@PPathole @Tesla @Teslarati @MKBHD Fixed in next release,8683,206,8889,2018-01-09
2066,950416244997488640,Mon Jan 08 17:17:45 +0000 2018,"Long exposure of rocket ascent, reentry from space and landing burn. (Credit @johnkrausphotos) https://t.co/X24k3han8M",21947,3355,25302,2018-01-08
2067,950191339349528576,Mon Jan 08 02:24:03 +0000 2018,RT @SpaceX: Falcon 9 first stage has landed at Landing Zone 1. https://t.co/679wN4F8kX,0,5255,5255,2018-01-08
2068,949859157493952513,Sun Jan 07 04:24:05 +0000 2018,@omerldiri @Tesla Good idea. We can just have the menu pop up as soon as you put the car into park.,4677,123,4800,2018-01-07
2069,949846430750920704,Sun Jan 07 03:33:31 +0000 2018,@yoda Of course. And an outdoor screen that plays a highlight reel of the best scenes in movie history.,4027,133,4160,2018-01-07
2070,949838199945281536,Sun Jan 07 03:00:48 +0000 2018,@mhmtkcn Near 405,1151,30,1181,2018-01-07
2071,949831212326993920,Sun Jan 07 02:33:02 +0000 2018,"Gonna put an old school drive-in, roller skates &amp; rock restaurant at one of the new Tesla Supercharger locations in LA",190353,17956,208309,2018-01-07
2072,949094319314558978,Fri Jan 05 01:44:53 +0000 2018,RT @ElectrekCo: Watch a Tesla Model X all-electric SUV tow a semi truck stuck in the snow https://t.co/HR9WbuoBTh https://t.co/5kqnXhbHpz,0,7369,7369,2018-01-05
2073,949075535459528705,Fri Jan 05 00:30:15 +0000 2018,https://t.co/3k71xzDIP1,30354,4229,34583,2018-01-05
2074,949075475036487680,Fri Jan 05 00:30:00 +0000 2018,Falcon Heavy goes vertical https://t.co/uG1k0WISv1,93737,16826,110563,2018-01-05
2075,948469610944241664,Wed Jan 03 08:22:31 +0000 2018,"Using a neural net to detect rain using cameras (no dedicated rain or sun sensors). Computers are very patient. 
https://t.co/YM0tQ6vLOV",19197,2579,21776,2018-01-03
2076,948428274467618816,Wed Jan 03 05:38:16 +0000 2018,Come work at the biggest &amp; most advanced factory on Earth! Located by a river near the beautiful Sierra Nevada moun… https://t.co/ydi2rIRPhF,58815,8196,67011,2018-01-03
2077,948426645429305344,Wed Jan 03 05:31:47 +0000 2018,RT @SpaceX: More photos of Falcon Heavy on the launch pad → https://t.co/095WHX44BX https://t.co/Z5aE1BUFSt,0,6769,6769,2018-01-03
2078,945814723521417217,Wed Dec 27 00:32:57 +0000 2017,@neilsiegel @Tesla Coming very soon,2540,73,2613,2017-12-27
2079,945749747129659392,Tue Dec 26 20:14:45 +0000 2017,@Kreative Vastly better maps/nav coming soon,3179,91,3270,2017-12-26
2080,945748731197980672,Tue Dec 26 20:10:43 +0000 2017,@dd_hogan Ok,3015,106,3121,2017-12-26
2081,945730195113365504,Tue Dec 26 18:57:03 +0000 2017,@Jason @Tesla Sure,5200,130,5330,2017-12-26
2082,945729852874694656,Tue Dec 26 18:55:42 +0000 2017,"@kabirakhtar Yeah, it’s terrible. Had to upgrade old Linux OS and a bunch of drivers first. Major browser upgrades… https://t.co/JXn5PPBoed",3440,112,3552,2017-12-26
2083,945729229001334784,Tue Dec 26 18:53:13 +0000 2017,@sustainableanna @VanSeedBank Similar total size. Maybe slightly bigger to account for a really gamechanging (I thi… https://t.co/zUgw2Ti5SO,4655,181,4836,2017-12-26
2084,945728690507231232,Tue Dec 26 18:51:05 +0000 2017,@IamSamCrompton Sustainable energy production with solar and batteries will grow much faster than auto on a percent… https://t.co/Q8woraLtcJ,2432,144,2576,2017-12-26
2085,945728300969746433,Tue Dec 26 18:49:32 +0000 2017,"@MCFlashTube Was gonna say we’ll do all but the last, but that last one sounds like good, cheesy fun :)",4744,122,4866,2017-12-26
2086,945727563187421185,Tue Dec 26 18:46:36 +0000 2017,@MadsVeiby Should be in next update,2760,47,2807,2017-12-26
2087,945727385269182464,Tue Dec 26 18:45:54 +0000 2017,@moskov Done,7437,243,7680,2017-12-26
2088,945713737729634304,Tue Dec 26 17:51:40 +0000 2017,@VanSeedBank I promise that we will make a pickup truck right after Model Y. Have had the core design/engineering e… https://t.co/L4HACngapn,16275,1543,17818,2017-12-26
2089,945713299068456962,Tue Dec 26 17:49:55 +0000 2017,"@SeanMahoneyAP Sorry for the delay. We have the most advanced AI neural net of any consumer product by far, so it’s… https://t.co/RFvnJ8tJDj",3874,209,4083,2017-12-26
2090,945712432416137217,Tue Dec 26 17:46:29 +0000 2017,Wanted again to send a note of deep gratitude to Tesla owners WW for taking a chance on a new company that all expe… https://t.co/IXOsJvjRjG,140915,13806,154721,2017-12-26
2091,945100013973020672,Mon Dec 25 01:12:57 +0000 2017,"@Nicmedia123 We will! At least, whatever is left over after we build the obelisks.",2611,104,2715,2017-12-25
2092,945099789741449216,Mon Dec 25 01:12:03 +0000 2017,@alhenry1231 The circle is complete,484,22,506,2017-12-25
2093,945058757653831680,Sun Dec 24 22:29:00 +0000 2017,@Steven_McKie Ok,714,83,797,2017-12-24
2094,945048998540226560,Sun Dec 24 21:50:14 +0000 2017,"Hats sold out, flamethrowers soon!",80803,8165,88968,2017-12-24
2095,944788312908218369,Sun Dec 24 04:34:21 +0000 2017,@ultralightbeam It does often seem that the most entertaining belief or outcome is the most likely to prevail,3664,203,3867,2017-12-24
2096,944787733079252992,Sun Dec 24 04:32:03 +0000 2017,@mrcsscco True,1679,31,1710,2017-12-24
2097,944787213430034432,Sun Dec 24 04:29:59 +0000 2017,So strange that people often believe things inversely proportionate to the evidence. Given a set of possible explan… https://t.co/WpJtntigln,111948,24790,136738,2017-12-24
2098,944783379022540800,Sun Dec 24 04:14:45 +0000 2017,@Kwebbelkop Yes,9471,391,9862,2017-12-24
2099,944779560104574977,Sun Dec 24 03:59:34 +0000 2017,Having a sinking feeling that most people actually do think it was aliens …,118391,16227,134618,2017-12-24
2100,944718722555453446,Sat Dec 23 23:57:50 +0000 2017,"When you get the new Tesla software update, go Ho Ho Ho. There’s an Easter egg inside the Easter egg, but it’s not funny.",35609,2775,38384,2017-12-23
2101,944710976930070528,Sat Dec 23 23:27:03 +0000 2017,"46k limited edition boring hats sold, 4K to go. Then flamethrower.",33047,2686,35733,2017-12-23
2102,944700127100497920,Sat Dec 23 22:43:56 +0000 2017,I think last night might have been the biggest Rorschach test ever,60397,7072,67469,2017-12-23
2103,944496926329733120,Sat Dec 23 09:16:29 +0000 2017,@planet4589 @CristatoLive @SpaceX Isn’t it obvious?,2438,189,2627,2017-12-23
2104,944495421161742336,Sat Dec 23 09:10:30 +0000 2017,"If you liked tonight’s launch, you will really like Falcon Heavy next month: 3 rocket cores &amp; 3X thrust. 2 cores re… https://t.co/BqJsoWKflF",125607,22166,147773,2017-12-23
2105,944413997163409410,Sat Dec 23 03:46:57 +0000 2017,"@NeerajKA Never heard of it
https://t.co/qTK5ICDxmm",11127,1121,12248,2017-12-23
2106,944399853316055040,Sat Dec 23 02:50:45 +0000 2017,Nuclear alien UFO from North Korea https://t.co/GUIHpKkkp5,312485,99270,411755,2017-12-23
2107,944382221435019264,Sat Dec 23 01:40:42 +0000 2017,@CristatoLive @SpaceX It was definitely aliens,33530,7032,40562,2017-12-23
2108,944379111358607360,Sat Dec 23 01:28:20 +0000 2017,Launch underway https://t.co/llNdEWbHBp,29053,4438,33491,2017-12-23
2109,943911396177096704,Thu Dec 21 18:29:48 +0000 2017,"@goodaudz @mtlbagelboy @paulkrugman His “PhD” is in literature (really), presumably bad fiction",2284,132,2416,2017-12-21
2110,943902052542849024,Thu Dec 21 17:52:40 +0000 2017,@redletterdave How much is it?,20439,3757,24196,2017-12-21
2111,943901463998169088,Thu Dec 21 17:50:20 +0000 2017,I love Twitter,189856,37152,227008,2017-12-21
2112,943887056492564480,Thu Dec 21 16:53:05 +0000 2017,"@rbrome @paulkrugman Bloody hell, I’m going to have to write a blog. Can’t fit this into tweets.",4251,204,4455,2017-12-21
2113,943885775308914688,Thu Dec 21 16:48:00 +0000 2017,@ben_made_new @paulkrugman I would only call someone an idiot if people were mistakenly under the impression that the person was smart,1811,266,2077,2017-12-21
2114,943882440984223747,Thu Dec 21 16:34:45 +0000 2017,"@paulkrugman However, public transit is obviously not fully solving the problem, as most major cities have been in… https://t.co/6gaz7gghio",2237,198,2435,2017-12-21
2115,943878616454127616,Thu Dec 21 16:19:33 +0000 2017,"@Youri_Hart Major navigation overhaul coming in early 2018. Will be light-years ahead of current system, but we are… https://t.co/NKDpWikmHW",1502,124,1626,2017-12-21
2116,943876138056663040,Thu Dec 21 16:09:42 +0000 2017,"@paulkrugman For the record, I actually love trains, most subways and London buses.",5582,252,5834,2017-12-21
2117,943875606130782208,Thu Dec 21 16:07:35 +0000 2017,"@paulkrugman Idiots can be very dangerous when they seem smart, but aren’t (having “PhD” in their bio is a dead giv… https://t.co/VZbvafB7Y5",10321,1678,11999,2017-12-21
2118,943867218776899584,Thu Dec 21 15:34:15 +0000 2017,Glad to see that Tesla owners are having a good experience. Working to improve further. Some cool software updates… https://t.co/7YUiawZCKu,23705,2137,25842,2017-12-21
2119,943857328662634496,Thu Dec 21 14:54:57 +0000 2017,@nickwadlow Sorry about that. Thanks for letting me know. Will get it fixed.,2034,41,2075,2017-12-21
2120,943699548169388032,Thu Dec 21 04:28:00 +0000 2017,@RichardGarriott Pics soon,992,66,1058,2017-12-21
2121,943669661165588481,Thu Dec 21 02:29:14 +0000 2017,RT @SpaceX: The SpaceX team recently completed production on our 400th Merlin 1D engine—the latest iteration of SpaceX’s rocket engine that…,0,3780,3780,2017-12-21
2122,943595786100604928,Wed Dec 20 21:35:41 +0000 2017,"@nzben @SwiftOnSecurity With people around, so you can see scale https://t.co/e0w1W0nJKv",5333,640,5973,2017-12-20
2123,943593718094880768,Wed Dec 20 21:27:28 +0000 2017,"@sally_alcot @NASA If things go perfectly, all three rocket booster cores will come back and land. Sides back at th… https://t.co/z1uQZAtt19",1631,176,1807,2017-12-20
2124,943592480926076928,Wed Dec 20 21:22:33 +0000 2017,Falcon Heavy launching from same @NASA pad as the Saturn V Apollo 11 moon rocket. It was 50% higher thrust with fiv… https://t.co/BQq3wthNRV,18161,1593,19754,2017-12-20
2125,943590152181448704,Wed Dec 20 21:13:17 +0000 2017,Max thrust at lift-off is 5.1 million pounds or 2300 metric tons. First mission will run at 92%.,17759,1594,19353,2017-12-20
2126,943535304417218560,Wed Dec 20 17:35:21 +0000 2017,@ClickHole Hate it when that happens. Some people are so rude!,10454,783,11237,2017-12-20
2127,943420026593337344,Wed Dec 20 09:57:16 +0000 2017,Falcon Heavy at the Cape https://t.co/hizfDVsU7X,132391,29119,161510,2017-12-20
2128,943330749809389569,Wed Dec 20 04:02:31 +0000 2017,@PainInTheArt Knight Rider is real,913,44,957,2017-12-20
2129,943196385373052934,Tue Dec 19 19:08:36 +0000 2017,Thanks! https://t.co/dr3cFPSXje,87139,10849,97988,2017-12-19
2130,943195824355512323,Tue Dec 19 19:06:22 +0000 2017,"RT @mnot: “Just a @elonmusk stunt” they said, yet it’s already affecting the whole Australian electricity market. https://t.co/Be4MmckeWU",0,3596,3596,2017-12-19
2131,942631583655198720,Mon Dec 18 05:44:17 +0000 2017,"RT @KM2__S: Man, how beautiful. @Tesla Model 3 
Here's Why the Tesla Model 3 Is the Coolest Car of 2017 @elonmusk #tesla #ElonMusk https://…",0,586,586,2017-12-18
2132,942631094519660544,Mon Dec 18 05:42:20 +0000 2017,RT @EricTopol: Yet another #AI milestone: superhuman performance in no-limit poker for the 1st time (wow) https://t.co/gVP2h7YFjR @sciencem…,0,1381,1381,2017-12-18
2133,942526513731260417,Sun Dec 17 22:46:46 +0000 2017,"@lukealization For now, we only use those on super hot reentry missions. Will go to all Ti with Falcon 9 V5, which is a few months away.",527,55,582,2017-12-17
2134,942524492462428160,Sun Dec 17 22:38:44 +0000 2017,@thomas_quinlan @slashdot @mavtechie @FlatEarthOrg Where’s the evidence!?,427,27,454,2017-12-17
2135,942524031185575937,Sun Dec 17 22:36:54 +0000 2017,@slashdot @mavtechie @FlatEarthOrg I also support the Concave Earth and Hollow Globe Societies. Just covering my bases …,591,52,643,2017-12-17
2136,941886160862724102,Sat Dec 16 04:22:14 +0000 2017,HG2G,8058,446,8504,2017-12-16
2137,941885122499899397,Sat Dec 16 04:18:07 +0000 2017,42k,17772,1202,18974,2017-12-16
2138,941699302782509057,Fri Dec 15 15:59:44 +0000 2017,RT @SpaceX: Falcon 9 first stage has landed at Landing Zone 1 — SpaceX’s 20th recovery of a first stage booster. https://t.co/DHLAf7hq7t,0,4374,4374,2017-12-15
2139,941551760799277056,Fri Dec 15 06:13:27 +0000 2017,@ALilling @humantransit Meant to say “sanctimonious idiot”,3347,293,3640,2017-12-15
2140,941551502400745472,Fri Dec 15 06:12:26 +0000 2017,@WIRED Good point. It’s just a really bad and fundamentally misleading article that doesn’t actually represent my p… https://t.co/UMzzSYhMG2,1693,122,1815,2017-12-15
2141,941505105420881921,Fri Dec 15 03:08:04 +0000 2017,@humantransit Sorry,3327,367,3694,2017-12-15
2142,941500121564332032,Fri Dec 15 02:48:15 +0000 2017,@humantransit You’re an idiot,41702,5552,47254,2017-12-15
2143,941496174208466944,Fri Dec 15 02:32:34 +0000 2017,"@WIRED This depressingly misleading &amp; misanthropic article came from a very brief digression at an AI conf, not fro… https://t.co/8lTuL8AzeG",12991,1311,14302,2017-12-15
2144,941390720799084544,Thu Dec 14 19:33:32 +0000 2017,@turnislefthome Yes,629,12,641,2017-12-14
2145,941390129418997761,Thu Dec 14 19:31:11 +0000 2017,"@LuisFCorreia Yeah, pretty much anywhere",506,12,518,2017-12-14
2146,941388896872493056,Thu Dec 14 19:26:17 +0000 2017,@IvanEscobosa Yes,625,11,636,2017-12-14
2147,941388347183841280,Thu Dec 14 19:24:06 +0000 2017,"10 hat aficionados, in appreciation for their exquisite taste in millinery, will be picked at random to tour the LA… https://t.co/Hg3a3nWLGe",23373,1736,25109,2017-12-14
2148,941043142404464641,Wed Dec 13 20:32:23 +0000 2017,@kaaningilamo Our existence cannot just be about solving one miserable problem after another. There need to be reasons to live.,26177,5656,31833,2017-12-13
2149,941042298283966464,Wed Dec 13 20:29:02 +0000 2017,It is high time that humanity went beyond Earth. Should have a moon base by now and sent astronauts to Mars. The fu… https://t.co/Kzvu6jcAdR,71683,15347,87030,2017-12-13
2150,940620874952073216,Tue Dec 12 16:34:27 +0000 2017,"35,000",26079,2174,28253,2017-12-12
2151,940359019947999232,Mon Dec 11 23:13:56 +0000 2017,"And those are just the really big ones. The Permian was especially bad, unless you were a mushroom.… https://t.co/za16Tz6A46",16160,3023,19183,2017-12-11
2152,940126370780160000,Mon Dec 11 07:49:28 +0000 2017,@Justin_Levy04 Safest flamethrower ever,3552,174,3726,2017-12-11
2153,940125978797281281,Mon Dec 11 07:47:54 +0000 2017,"I know it’s a little off-brand, but kids love it",31089,2055,33144,2017-12-11
2154,940056523304181762,Mon Dec 11 03:11:55 +0000 2017,"After 50k hats, we will start selling The Boring Company flamethrower",73321,9881,83202,2017-12-11
2155,940055330859315202,Mon Dec 11 03:07:10 +0000 2017,"Over 30,000 hats sold!",23779,1150,24929,2017-12-11
2156,939005893634506752,Fri Dec 08 05:37:05 +0000 2017,@tiamaria68uk Plus a towel and a sign saying “Don’t Panic”,2243,220,2463,2017-12-08
2157,938972633416306690,Fri Dec 08 03:24:55 +0000 2017,"On Tuesday, SpaceX will attempt to refly both an orbital rocket and spacecraft for the first… https://t.co/Wm5SpjNdMb",29010,4448,33458,2017-12-08
2158,938947119246860290,Fri Dec 08 01:43:32 +0000 2017,@tiamaria68uk Yes,1430,65,1495,2017-12-08
2159,938816780444745728,Thu Dec 07 17:05:37 +0000 2017,@FortuneTech Do it,104911,22789,127700,2017-12-07
2160,937447589460426752,Sun Dec 03 22:24:56 +0000 2017,The *real* money comes from merchandising. I learned it from this documentary https://t.co/E4gpqhl6KF,22720,3977,26697,2017-12-03
2161,937446602393841664,Sun Dec 03 22:21:01 +0000 2017,@sm_carl Deal,1149,33,1182,2017-12-03
2162,937411489635241984,Sun Dec 03 20:01:30 +0000 2017,"That special hat delivery will take place deep within the real, but fictional (of course), tunnel we are building u… https://t.co/2XLWO39Ic0",11679,854,12533,2017-12-03
2163,937405455768346624,Sun Dec 03 19:37:31 +0000 2017,@NefuDaBoss Beyond anything you can imagine,1509,56,1565,2017-12-03
2164,937404412858740736,Sun Dec 03 19:33:22 +0000 2017,"@TheRealUtkarsh And, at the risk of stating the obvious, extremely boring",1923,43,1966,2017-12-03
2165,937403444192624640,Sun Dec 03 19:29:31 +0000 2017,@TheRealUtkarsh Because it’s stupid,1637,51,1688,2017-12-03
2166,937403272213569536,Sun Dec 03 19:28:50 +0000 2017,@maralkalajian Maybe,1836,42,1878,2017-12-03
2167,937402084692975616,Sun Dec 03 19:24:07 +0000 2017,Every 5000th buyer of our boringly boring hat will get a free hat signed by the delivery guy https://t.co/11TYEUSG4M,27726,3146,30872,2017-12-03
2168,937401166299774976,Sun Dec 03 19:20:28 +0000 2017,Hat,10444,2072,12516,2017-12-03
2169,937397949876727808,Sun Dec 03 19:07:41 +0000 2017,@IvanEscobosa Yes,1115,40,1155,2017-12-03
2170,937397813637296128,Sun Dec 03 19:07:09 +0000 2017,@harrisonlingren @JW8888888 Busted,1493,55,1548,2017-12-03
2171,937397330998845440,Sun Dec 03 19:05:14 +0000 2017,"To preserve the transcendent majesty &amp; specialness of The Boring Company cap, we are capping cap orders at 50,000 c… https://t.co/nfFHEqagyD",10104,933,11037,2017-12-03
2172,937109615698894848,Sun Dec 03 00:01:57 +0000 2017,@novaspivack That’s certainly the right way to go to store massive amounts of data for a long time,1943,94,2037,2017-12-03
2173,937090715225427968,Sat Dec 02 22:46:51 +0000 2017,@novaspivack Asimov’s Foundation books should def be part of the mission. They’re amazing.,3957,340,4297,2017-12-02
2174,937041986304983040,Sat Dec 02 19:33:13 +0000 2017,@highqualitysh1t I love the thought of a car drifting apparently endlessly through space and perhaps being discover… https://t.co/SpZ6qLbzi3,3794,618,4412,2017-12-02
2175,936838844602728449,Sat Dec 02 06:06:00 +0000 2017,@bonnienorman Red car for a red planet,2598,204,2802,2017-12-02
2176,936829494874091520,Sat Dec 02 05:28:51 +0000 2017,@mswagle Yeah,1033,32,1065,2017-12-02
2177,936793680517595136,Sat Dec 02 03:06:32 +0000 2017,@JC_Channel Yes,5072,400,5472,2017-12-02
2178,936782477502246912,Sat Dec 02 02:22:01 +0000 2017,Payload will be my midnight cherry Tesla Roadster playing Space Oddity. Destination is Mars orbit. Will be in deep… https://t.co/clunBATxJr,82853,17047,99900,2017-12-02
2179,936781265675599873,Sat Dec 02 02:17:12 +0000 2017,Falcon Heavy to launch next month from Apollo 11 pad at the Cape. Will have double thrust of next largest rocket. G… https://t.co/oaQGB9rzEG,47694,9094,56788,2017-12-02
2180,936319255032635392,Thu Nov 30 19:41:21 +0000 2017,"RT @Tesla: New @UCSUSA study shows that across the US, driving an electric car is not just cleaner, but costs less to drive than a gasoline…",0,2190,2190,2017-11-30
2181,936270959941640192,Thu Nov 30 16:29:26 +0000 2017,@LanceUlanoff What does it look like?,533,22,555,2017-11-30
2182,936263871295361025,Thu Nov 30 16:01:16 +0000 2017,Racing video part 2 https://t.co/nQvm2R9K0h,10927,2186,13113,2017-11-30
2183,936072506951307264,Thu Nov 30 03:20:51 +0000 2017,Model X races a gasoline sports car while towing a sports car https://t.co/xLIwxpZ36r,13577,1898,15475,2017-11-30
2184,936066967173193729,Thu Nov 30 02:58:50 +0000 2017,"@FredericLambert Electric pods for sure. Rails maybe, maybe not.",431,30,461,2017-11-30
2185,936062403606822913,Thu Nov 30 02:40:42 +0000 2017,"@FredericLambert A Loop is like a Hyperloop, but without drawing a vacuum inside the tube. Don’t need to get rid of… https://t.co/PmRjQcRTsp",465,45,510,2017-11-30
2186,936062050555400192,Thu Nov 30 02:39:18 +0000 2017,@FredericLambert Kinda,699,21,720,2017-11-30
2187,936060082290167808,Thu Nov 30 02:31:29 +0000 2017,"The Boring Company will compete to fund, build &amp; operate a high-speed Loop connecting Chicago O’Hare Airport to dow… https://t.co/33qhtJbFbo",36365,6849,43214,2017-11-30
2188,935572279693516800,Tue Nov 28 18:13:08 +0000 2017,Why is there no Flat Mars Society!?,97336,29043,126379,2017-11-28
2189,935405847215144960,Tue Nov 28 07:11:47 +0000 2017,"@KeithManaloto_ @pieterdewit_nz @ThisIsSandeepG As I’ve said before, I am definitely a Martian",1530,172,1702,2017-11-28
2190,935405154752274433,Tue Nov 28 07:09:02 +0000 2017,RT @wef: These are the tech companies people most want to work for https://t.co/2D5kRXbgyX https://t.co/YiCf01PAT0,0,2116,2116,2017-11-28
2191,935380867056222208,Tue Nov 28 05:32:31 +0000 2017,@pieterdewit_nz @ThisIsSandeepG int main(){},1085,98,1183,2017-11-28
2192,935329447594541056,Tue Nov 28 02:08:12 +0000 2017,"@ThisIsSandeepG Not true. A friend sent me part of a BTC a few years, but I don’t know where it is.",4028,503,4531,2017-11-28
2193,935314994371186688,Tue Nov 28 01:10:46 +0000 2017,"Mars sky is the opposite of Earth
Blue sunrise and sunset
Red during the day https://t.co/RjmSZ98bCz",89360,17247,106607,2017-11-28
2194,935250797234753536,Mon Nov 27 20:55:40 +0000 2017,"@WorldAndScience Wow, they played D&amp;D in D&amp;D",14248,1653,15901,2017-11-27
2195,935048096773369857,Mon Nov 27 07:30:13 +0000 2017,@nsylianteng It’s there. Just unfold the visor and lift the cover.,424,27,451,2017-11-27
2196,934890107508625408,Sun Nov 26 21:02:25 +0000 2017,@Gloryless Otherwise you’d only see a blur,10052,291,10343,2017-11-26
2197,934889932807593984,Sun Nov 26 21:01:44 +0000 2017,"Got to regulate AI/robotics like we do food, drugs, aircraft &amp; cars. Public risks require public oversight. Getting… https://t.co/pMiIrX1NMl",29338,7037,36375,2017-11-26
2198,934888089058549760,Sun Nov 26 20:54:24 +0000 2017,"This is nothing. In a few years, that bot will move so fast you’ll need a strobe light to see it. Sweet dreams… https://t.co/0MYNixQXMw",271332,89364,360696,2017-11-26
2199,934505268343394307,Sat Nov 25 19:33:12 +0000 2017,"Thanksgiving in the Rockies. Love my bro @kimbal. Radishing t-shirt courtesy of his company,… https://t.co/FB6rTbFdK8",7895,395,8290,2017-11-25
2200,934024631769534464,Fri Nov 24 11:43:20 +0000 2017,@bjornlilja Adjusting soon,316,16,332,2017-11-24
2201,933576358793318401,Thu Nov 23 06:02:03 +0000 2017,Congratulations to the Tesla crew and South Australian authorities who worked so hard to get this manufactured and… https://t.co/xLOhH7EXiQ,40868,7954,48822,2017-11-23
2202,933077329722580992,Tue Nov 21 20:59:05 +0000 2017,Initial Hat Offering going great w over $300k in hat sales already! Thanks for buying our super boring hat. You roc… https://t.co/PpmDpNyNXT,14990,1491,16481,2017-11-21
2203,932649922666438656,Mon Nov 20 16:40:44 +0000 2017,@schesnais Good point,386,21,407,2017-11-20
2204,932326631342927873,Sun Nov 19 19:16:05 +0000 2017,"@commagere For one thing, aliens obv built the pyramids! Who but aliens could have figured out how to align and sta… https://t.co/w6SNoDGlE1",9927,1310,11237,2017-11-19
2205,932322853009080320,Sun Nov 19 19:01:04 +0000 2017,"Not saying the next gen Roadster special upgrade package *will* definitely enable it to fly short hops, but maybe …… https://t.co/VCCoVgV0hs",37343,6794,44137,2017-11-19
2206,932113939181092864,Sun Nov 19 05:10:55 +0000 2017,Should clarify that this is the base model performance. There will be a special option package that takes it to the next level.,60120,8304,68424,2017-11-19
2207,931412020016029696,Fri Nov 17 06:41:45 +0000 2017,Tesla Semi https://t.co/7VLz7F46Ji,122058,24479,146537,2017-11-17
2208,931407490889084928,Fri Nov 17 06:23:45 +0000 2017,0 to 100 km/h in 1.9 sec https://t.co/xTOTDGuwQj,459610,118387,577997,2017-11-17
2209,930876845959946240,Wed Nov 15 19:15:09 +0000 2017,"Sorry, date is tomorrow night at 8pm. This pic is from the old invite.",14899,877,15776,2017-11-15
2210,930875739397791744,Wed Nov 15 19:10:45 +0000 2017,"It can transform into a robot, fight aliens and make one hell of a latte https://t.co/8h9vvWu4f5",75706,15295,91001,2017-11-15
2211,930681760026853377,Wed Nov 15 06:19:57 +0000 2017,@rjcc @Tesla Do you really believe that someone’s life should be ruined if they make a single offensive comment for… https://t.co/LfYSE2NWzK,1057,84,1141,2017-11-15
2212,930677629161758726,Wed Nov 15 06:03:32 +0000 2017,"@rjcc @Tesla That is a *counterpoint* to illustrate absurdity, meaning that obviously a single careless statement s… https://t.co/tb772qKz2a",869,37,906,2017-11-15
2213,930675232825888768,Wed Nov 15 05:54:01 +0000 2017,RT @Tesla: Hotbed of Misinformation https://t.co/7zMc7Rj9zZ,0,1803,1803,2017-11-15
2214,930625666441023489,Wed Nov 15 02:37:03 +0000 2017,RT @Tesla: MIT researchers rebut misleading @FT article — truth is that EVs are way cleaner than petrol cars https://t.co/Pv7K9tU7hr https:…,0,3976,3976,2017-11-15
2215,930100328229244928,Mon Nov 13 15:49:33 +0000 2017,@newscientist ... say scientists — among other insights gained — after a large vat of LSD overturned in the lab. Al… https://t.co/zTamxyErGn,13257,2105,15362,2017-11-13
2216,929823757635481600,Sun Nov 12 21:30:33 +0000 2017,Tesla Semi Truck unveil to be webcast live on Thursday at 8pm! This will blow your mind clear out of your skull and… https://t.co/3yKRDpCUqZ,119664,27030,146694,2017-11-12
2217,929564225164464128,Sun Nov 12 04:19:16 +0000 2017,Sunset at the Gigafactory https://t.co/KpUuK7bktk,46416,3259,49675,2017-11-12
2218,929090906606542848,Fri Nov 10 20:58:28 +0000 2017,@newscientist Sure ...,21253,2759,24012,2017-11-10
2219,928675794372608001,Thu Nov 09 17:28:57 +0000 2017,"""If one day, my words are against science, choose science.""
Mustafa Kemal Atatürk",206197,89763,295960,2017-11-09
2220,928671721065992192,Thu Nov 09 17:12:46 +0000 2017,"I placed the flowers

Three broken ribs
A pierced lung
And still he fought
For peace at… https://t.co/MeEKf2ZntM",56942,8760,65702,2017-11-09
2221,928335114353831937,Wed Nov 08 18:55:13 +0000 2017,Atatürk Anıtkabir https://t.co/al3wt0njr6,115653,28917,144570,2017-11-08
2222,927986199079264256,Tue Nov 07 19:48:45 +0000 2017,"@Bob_Richards One rocket, slightly toasted",7271,402,7673,2017-11-07
2223,925024279938269184,Mon Oct 30 15:39:09 +0000 2017,RT @SpaceX: Falcon 9 and Koreasat-5A went vertical last night on Pad 39A. Today’s launch window opens at 3:34 p.m. EDT → https://t.co/gtC39…,0,1755,1755,2017-10-30
2224,924389383792312320,Sat Oct 28 21:36:18 +0000 2017,@uncover007 500 ft so far. Should be 2 miles long in three or four months and hopefully stretch the whole 405 N-S c… https://t.co/BfoqYKJg3u,2220,207,2427,2017-10-28
2225,924387972161552384,Sat Oct 28 21:30:41 +0000 2017,Picture of The Boring Company LA tunnel taken yesterday https://t.co/TfdVKyXFsJ,60084,8650,68734,2017-10-28
2226,923657991664095232,Thu Oct 26 21:10:00 +0000 2017,"Btw, just want to express a word of appreciation for the hard work of the Tesla Gigafactory team. Reason I camped o… https://t.co/Nztp84BSLW",42445,3561,46006,2017-10-26
2227,923576364652953601,Thu Oct 26 15:45:39 +0000 2017,"Whiskey, fire, s’mores and JC

Also, hotdog or not hotdog? https://t.co/86cxwbZyWB",11679,1136,12815,2017-10-26
2228,923469108917755904,Thu Oct 26 08:39:27 +0000 2017,Campfire on the Gigafactory roof https://t.co/JKxaKUzvZY,8977,712,9689,2017-10-26
2229,923339941957976065,Thu Oct 26 00:06:11 +0000 2017,Just feed it The Godfather movies as input. What’s the worst that could happen? https://t.co/WX4Kx45csv,20414,4975,25389,2017-10-26
2230,922905342148616192,Tue Oct 24 19:19:14 +0000 2017,RT @Tesla: Hospital del Niño is first of many solar+storage projects going live. Grateful to support the recovery of Puerto Rico with @rica…,0,15254,15254,2017-10-24
2231,922829439364423680,Tue Oct 24 14:17:38 +0000 2017,@lorengrush @verge It’s true tho,657,36,693,2017-10-24
2232,922828793152229378,Tue Oct 24 14:15:04 +0000 2017,@verge Groan,4084,281,4365,2017-10-24
2233,922827170375983105,Tue Oct 24 14:08:37 +0000 2017,"RT @OpenAI: Beating stronger opponents by adapting to their strategies, via meta-learning: https://t.co/hfqL73wYYw",0,476,476,2017-10-24
2234,922825300068720640,Tue Oct 24 14:01:11 +0000 2017,"RT @OpenAI: AIs which develop faking, tackling, blocking, kicking through self-play: https://t.co/Ml4AAqFa67",0,685,685,2017-10-24
2235,922691827031068672,Tue Oct 24 05:10:49 +0000 2017,"On the list of people who should absolutely *not* be allowed to develop digital superintelligence...
https://t.co/reNZ50FGNC",23202,6573,29775,2017-10-24
2236,921587018412339200,Sat Oct 21 04:00:42 +0000 2017,"@nextspaceflight @jamesbarr1991 Yeah, don't exactly need to be Sherlock Holmes.",481,27,508,2017-10-21
2237,921575999384326145,Sat Oct 21 03:16:54 +0000 2017,@jamesharvey1991 It won't even need to ask you most of the time,401,30,431,2017-10-21
2238,921575783813939200,Sat Oct 21 03:16:03 +0000 2017,"@atlasobscura A reminder of the youth of our 10,000 year (to be generous) civilization. We are not even a flash in… https://t.co/FXEDnXjwoh",12350,1961,14311,2017-10-21
2239,921419557918597120,Fri Oct 20 16:55:16 +0000 2017,"@APTA_info @baltimoresun Not ready to do a proper announcement yet, but maybe in a month or so. Maryland has been a… https://t.co/3NtBwkQS7b",3899,356,4255,2017-10-20
2240,921183170757738497,Fri Oct 20 01:15:57 +0000 2017,@bachism But the hat is real!,765,36,801,2017-10-20
2241,921177181585154048,Fri Oct 20 00:52:09 +0000 2017,RT @RickandMorty: Simulation theory confirmed. https://t.co/2sAHlIXV4v,0,15142,15142,2017-10-20
2242,921050992707190784,Thu Oct 19 16:30:43 +0000 2017,"Congratulations to Coulter Tilton of Missouri, buyer of hat 5000! You have won a free hat signed by the Boring team.",13859,672,14531,2017-10-19
2243,921027496702746624,Thu Oct 19 14:57:21 +0000 2017,Now at 6400 hats …,15995,1027,17022,2017-10-19
2244,920864873940107265,Thu Oct 19 04:11:09 +0000 2017,@CalebH92 There is an actual tunnel and it's getting longer every day,552,34,586,2017-10-19
2245,920845980467163139,Thu Oct 19 02:56:04 +0000 2017,It all comes full circle https://t.co/zqiCDLhFWy,29749,2948,32697,2017-10-19
2246,920844783542853633,Thu Oct 19 02:51:19 +0000 2017,"Second boring machine almost ready. Will be called Line-Storm, after the poem by Frost. ""And be my love in the rain… https://t.co/j2BR8mhpZS",11201,1658,12859,2017-10-19
2247,920834201535913985,Thu Oct 19 02:09:16 +0000 2017,@freddier @TalulahRiley And credit for the logo art to JJ Abrams,471,24,495,2017-10-19
2248,920833104721297408,Thu Oct 19 02:04:55 +0000 2017,Almost 4000 hats sold so far. Whoever buys the 5000th gets a free hat with their hat! https://t.co/x87eVge68U,15310,1832,17142,2017-10-19
2249,920830970395222016,Thu Oct 19 01:56:26 +0000 2017,"@freddier Btw, credit for The Boring Company name goes to @TalulahRiley",662,45,707,2017-10-19
2250,920704022104780800,Wed Oct 18 17:31:59 +0000 2017,RT @OpenAI: Building advanced AI and only then making it safe is like building the internet and later trying to make it secure: https://t.c…,0,1961,1961,2017-10-18
2251,920520208275660800,Wed Oct 18 05:21:34 +0000 2017,@freddier Gonna build that tunnel one hat at a time,3438,366,3804,2017-10-18
2252,920482298327216128,Wed Oct 18 02:50:56 +0000 2017,The world's most boring hat  https://t.co/rnHPgyhx4Z,23064,3376,26440,2017-10-18
2253,919999012899454976,Mon Oct 16 18:50:32 +0000 2017,Amazing sim of neutron stars colliding https://t.co/E38rna81TK,16692,4222,20914,2017-10-16
2254,919980024366632960,Mon Oct 16 17:35:04 +0000 2017,@DJ_Mr_Cool That was a joke. I didn't realize people actually used those.,294,16,310,2017-10-16
2255,919675564423708673,Sun Oct 15 21:25:15 +0000 2017,Yesterday's Reddit Ask Me Anything about BFR. You're welcome nk! https://t.co/g2giimsW8b,8637,1438,10075,2017-10-15
2256,919262509227323392,Sat Oct 14 18:03:55 +0000 2017,BFR AMA on r/space in 2 hours,14371,1880,16251,2017-10-14
2257,919258411795079169,Sat Oct 14 17:47:39 +0000 2017,@SpaceX And other places,5381,458,5839,2017-10-14
2258,918518924475379713,Thu Oct 12 16:49:11 +0000 2017,@_andyoneal @patriciapaje That's just to win our Hyperloop student competition in ~1 mile tube. Practical version w… https://t.co/JwwcbW7Q4B,401,30,431,2017-10-12
2259,918517097839202305,Thu Oct 12 16:41:56 +0000 2017,@benbenwilde @patriciapaje Party time!,375,28,403,2017-10-12
2260,918516707735437313,Thu Oct 12 16:40:22 +0000 2017,"@Barnacules To be more inclusive, how about a ""pick your tech level"" setting. Could make the Tesla sound like horse… https://t.co/3R9rz77rpU",1449,157,1606,2017-10-12
2261,918506265151598592,Thu Oct 12 15:58:53 +0000 2017,@patriciapaje Aim for 10 kN of thrust on a 200 kg sled. a=F/m ... game over.,316,21,337,2017-10-12
2262,918333638567186438,Thu Oct 12 04:32:55 +0000 2017,Stamping Model 3 Body Panels (real-time) https://t.co/hhNFW8VUEE,12705,1729,14434,2017-10-12
2263,918322382560825344,Thu Oct 12 03:48:12 +0000 2017,@ManMadeMoon I own two gasoline cars. One is a Model T that a friend gave me and the other is a Series 1 '67 E-type Roadster. My first love.,6152,253,6405,2017-10-12
2264,918316559864492032,Thu Oct 12 03:25:04 +0000 2017,RT @xerosome: @SpaceX Awesome night-time shot of the Falcon 9 plummeting toward the droneship! #Iridium3 https://t.co/h5eSoKPHNO,0,570,570,2017-10-12
2265,918316304129388544,Thu Oct 12 03:24:03 +0000 2017,"@jirgebeaner No, but I do have a Gundam Wing",654,133,787,2017-10-12
2266,918314470048382977,Thu Oct 12 03:16:45 +0000 2017,@RITSPEX This weekend,583,48,631,2017-10-12
2267,918313446550265857,Thu Oct 12 03:12:41 +0000 2017,Just posted a photo https://t.co/a9xf4G6dmE,5427,584,6011,2017-10-12
2268,918248278835191809,Wed Oct 11 22:53:44 +0000 2017,RT @SpaceX: Webcast of Falcon 9 launch now live → https://t.co/gtC39uBC7z,0,888,888,2017-10-11
2269,918167666908528640,Wed Oct 11 17:33:25 +0000 2017,RT @SpaceX: Falcon 9 and EchoStar 105/SES-11 went vertical last night on Pad 39A. https://t.co/WWLoIobQb3,0,1471,1471,2017-10-11
2270,918003287600668673,Wed Oct 11 06:40:14 +0000 2017,@patriciapaje Very high pressure air cold gas thruster,309,22,331,2017-10-11
2271,917446906707460096,Mon Oct 09 17:49:22 +0000 2017,"RT @Cmdr_Hadfield: Mars has 5 million cubic km of ice, enough to cover the whole planet to a depth of 35 m/ 115 ft. Just need to warm it up…",0,4064,4064,2017-10-09
2272,917413806363394048,Mon Oct 09 15:37:50 +0000 2017,The last of ten Iridium global communication satellites delivered to orbit several hundred miles… https://t.co/TG7hNkltQd,9971,1129,11100,2017-10-09
2273,917406055994335232,Mon Oct 09 15:07:02 +0000 2017,RT @SpaceX: Successful deployment of 10 @IridiumComm NEXT satellites to low-Earth orbit confirmed. https://t.co/w6pzeefmzO,0,1799,1799,2017-10-09
2274,917372495967031296,Mon Oct 09 12:53:41 +0000 2017,RT @SpaceX: Falcon 9 first stage has landed on Just Read the Instructions. https://t.co/CS40cSiqSP,0,3984,3984,2017-10-09
2275,917163455051735040,Sun Oct 08 23:03:02 +0000 2017,@aniesh_vishnu @ProductHunt Everything all at once,850,79,929,2017-10-08
2276,917160402567364608,Sun Oct 08 22:50:54 +0000 2017,@balajis_ That is actual speed. It is slowed down right now to confirm build consistency and so that a person can s… https://t.co/NO1w2Q0jH6,861,43,904,2017-10-08
2277,917154829008605184,Sun Oct 08 22:28:45 +0000 2017,The Model 3 body line slowed down to 1/10th speed https://t.co/VVTthqFzF7,8634,1285,9919,2017-10-08
2278,917153183222263808,Sun Oct 08 22:22:13 +0000 2017,Jupiter is big https://t.co/poXgvKPZv7,29208,4549,33757,2017-10-08
2279,917134987270303744,Sun Oct 08 21:09:55 +0000 2017,@0a0010 @ProductHunt Don't underestimate the power of chakras,904,160,1064,2017-10-08
2280,917103257494839296,Sun Oct 08 19:03:50 +0000 2017,"@ProductHunt Just kept working on my crown chakra and boom! Don't let anyone tell you magic isn't real. Warning, EX… https://t.co/AaRBIJaBCK",8962,1383,10345,2017-10-08
2281,916782879962574848,Sat Oct 07 21:50:46 +0000 2017,@verge This doesn't even *seem* innocent,27872,4313,32185,2017-10-07
2282,916518956050956288,Sat Oct 07 04:22:01 +0000 2017,@Reuters You forgot to add the video version of their response https://t.co/eaqzC6rgQE,7946,1372,9318,2017-10-07
2283,916480204033335296,Sat Oct 07 01:48:02 +0000 2017,RT @ricardorossello: Great initial conversation with @elonmusk tonight. Teams are now talking; exploring opportunities. Next steps soon to…,0,4444,4444,2017-10-07
2284,916407361899708416,Fri Oct 06 20:58:35 +0000 2017,@FredericLambert @MacTechGenius @blundell_apps Assume the worst. Now I need to get back to work...,776,51,827,2017-10-06
2285,916407144047558656,Fri Oct 06 20:57:43 +0000 2017,@teslamodel3fan @FredericLambert @MacTechGenius @blundell_apps Answers: Yes. No. Doesn't matter.,457,25,482,2017-10-06
2286,916406412112039937,Fri Oct 06 20:54:49 +0000 2017,"@FredericLambert @MacTechGenius @blundell_apps There is only one config being built right now, so the only question… https://t.co/h1FKyHvybS",704,39,743,2017-10-06
2287,916402688127930373,Fri Oct 06 20:40:01 +0000 2017,@FredericLambert @MacTechGenius @blundell_apps Bear in mind that the production ramp is an exponential curve. Late… https://t.co/DAp6XYIhSW,807,48,855,2017-10-06
2288,916401820620091393,Fri Oct 06 20:36:34 +0000 2017,"@MacTechGenius @blundell_apps Dec will be a big month, so probably, but it is impossible to be certain right now",277,12,289,2017-10-06
2289,916401512661663750,Fri Oct 06 20:35:21 +0000 2017,@OutOnALumb @engadget Yeah,515,10,525,2017-10-06
2290,916401222487126016,Fri Oct 06 20:34:12 +0000 2017,"@nextspaceflight @MacTechGenius @blundell_apps I'm doing my best to recalibrate, but that is a fair criticism. Howe… https://t.co/PMKraHjNUw",1677,172,1849,2017-10-06
2291,916400157972848640,Fri Oct 06 20:29:58 +0000 2017,@annerajb Med medical equipment has priority,791,31,822,2017-10-06
2292,916399837129564163,Fri Oct 06 20:28:41 +0000 2017,@MacTechGenius @blundell_apps Probably 6 to 8 weeks,684,29,713,2017-10-06
2293,916397212891877376,Fri Oct 06 20:18:16 +0000 2017,@blundell_apps You'll know as soon as we do. We are deep in production hell 🔥,1856,85,1941,2017-10-06
2294,916396499310751745,Fri Oct 06 20:15:25 +0000 2017,@nextspaceflight Or do you?,1056,16,1072,2017-10-06
2295,916396399482232832,Fri Oct 06 20:15:02 +0000 2017,@14agrim High pain tolerance,2590,188,2778,2017-10-06
2296,916396250114670592,Fri Oct 06 20:14:26 +0000 2017,"@Temeyers Semi specs are better than anything I've seen reported so far. Semi eng/design team work is aces, but oth… https://t.co/IHjisplb67",976,56,1032,2017-10-06
2297,916395155120205825,Fri Oct 06 20:10:05 +0000 2017,Tesla Semi unveil now Nov 16. Diverting resources to fix Model 3 bottlenecks &amp; increase battery production for Puer… https://t.co/VfWMLeTAwN,54271,9774,64045,2017-10-06
2298,916376799466024960,Fri Oct 06 18:57:09 +0000 2017,@MacTechGenius @Jon4Lakers @solarcity @Tesla Not good. Sounds like some 3rd party installers are taking advantage o… https://t.co/oYKJToIOfl,433,21,454,2017-10-06
2299,916336207935635457,Fri Oct 06 16:15:51 +0000 2017,@ismailnathij @stapf @Tesla The internal Tesla Powerwall install team in PR is very small right now. Sending experi… https://t.co/4z5JfXzSoi,1337,246,1583,2017-10-06
2300,916333129928810496,Fri Oct 06 16:03:37 +0000 2017,"@ismailnathij @stapf @Tesla Tesla always charges the same price for a Powerwall (only taxes &amp; shipping costs vary),… https://t.co/NFL08ZY9p1",1211,160,1371,2017-10-06
2301,916319581337133056,Fri Oct 06 15:09:47 +0000 2017,"@ricardorossello Sounds good, I look forward to talking later today",8808,874,9682,2017-10-06
2302,916234148104118272,Fri Oct 06 09:30:18 +0000 2017,"@ricardorossello I would be happy to talk. Hopefully, Tesla can be helpful.",5580,1328,6908,2017-10-06
2303,916030871232176129,Thu Oct 05 20:02:33 +0000 2017,"@RickandMorty Hell yeah, with that crew, we will party like Escobar and Cobain wish they could've partied!!",12640,2122,14762,2017-10-05
2304,916018504209383424,Thu Oct 05 19:13:24 +0000 2017,@RickandMorty We should definitely get a room ...,8846,962,9808,2017-10-05
2305,915990261938786304,Thu Oct 05 17:21:11 +0000 2017,"@RickandMorty I know that closet is nice and warm, but it's time you admitted you are one of the creators of the ne… https://t.co/A5vPrioiZ0",8335,736,9071,2017-10-05
2306,915988011602423808,Thu Oct 05 17:12:14 +0000 2017,@LoganJastremski I'm auditioning to be a roofing spokesmodel  in the greater Reno area,5847,239,6086,2017-10-05
2307,915957815197319168,Thu Oct 05 15:12:15 +0000 2017,@RickandMorty The singularity for this level of the simulation is coming soon. I wonder what the levels above us lo… https://t.co/BBe3w78sIs,16511,2685,19196,2017-10-05
2308,915939199718531072,Thu Oct 05 13:58:17 +0000 2017,"@stapf The Tesla team has done this for many smaller islands around the world, but there is no scalability limit, s… https://t.co/HN5mWXRhgO",33595,9753,43348,2017-10-05
2309,915831795446190085,Thu Oct 05 06:51:30 +0000 2017,@RickandMorty Final episode was disgustingly good,58269,9744,68013,2017-10-05
2310,915774920541446144,Thu Oct 05 03:05:29 +0000 2017,I believe I can fly https://t.co/nMBgPiAUJR,14618,2655,17273,2017-10-05
2311,915453138051768320,Wed Oct 04 05:46:51 +0000 2017,Aiming for two rocket landings in 48 hours this weekend https://t.co/C1CZW2cQgv,24501,3476,27977,2017-10-04
2312,914948623208611840,Mon Oct 02 20:22:05 +0000 2017,"RT @WIRED: GM just announced that it is working toward an all-electric, zero-emissions future https://t.co/fjSzkACMEO",0,2099,2099,2017-10-02
2313,914734726493102082,Mon Oct 02 06:12:08 +0000 2017,"@YasserHZain @verge It would need to refill to return, but it could get to Jupiter with low payload",591,50,641,2017-10-02
2314,914734128427278336,Mon Oct 02 06:09:45 +0000 2017,@YasserHZain @verge Homes on Jupiter with solar-power *and* a Powerwall going right now for great price!,950,94,1044,2017-10-02
2315,913775198423408640,Fri Sep 29 14:39:19 +0000 2017,"@MeltingIce Assuming max acceleration of 2 to 3 g's, but in a comfortable direction. Will feel like a mild to moder… https://t.co/fpjmEgrHfC",2368,277,2645,2017-09-29
2316,913670910019870725,Fri Sep 29 07:44:54 +0000 2017,"RT @SpaceX: BFR is capable of transporting satellites to orbit, crew and cargo to the @Space_Station and completing missions to the Moon an…",0,7428,7428,2017-09-29
2317,913669661505544194,Fri Sep 29 07:39:57 +0000 2017,@bigajm Yup :),445,21,466,2017-09-29
2318,913658652430671872,Fri Sep 29 06:56:12 +0000 2017,Part 2 https://t.co/8Fvu57muhM,8402,2343,10745,2017-09-29
2319,913649379281534976,Fri Sep 29 06:19:21 +0000 2017,Fly to most places on Earth in under 30 mins and anywhere in under 60. Cost per seat should be… https://t.co/dGYDdGttYd,39759,14712,54471,2017-09-29
2320,913643874836291584,Fri Sep 29 05:57:29 +0000 2017,"RT @SpaceX: Supporting the creation of a permanent, self-sustaining human presence on Mars. https://t.co/kCtBLPbSg8 https://t.co/ra6hKsrOcG",0,11541,11541,2017-09-29
2321,913642747197743104,Fri Sep 29 05:53:00 +0000 2017,BFR will take you anywhere on Earth in less than 60 mins https://t.co/HWt9BZ1FI9,27361,14113,41474,2017-09-29
2322,913600101460955141,Fri Sep 29 03:03:32 +0000 2017,"Mars City
Opposite of Earth. Dawn and dusk sky are blue on Mars and day sky is red. https://t.co/XHcZIdgqnb",18389,4493,22882,2017-09-29
2323,913595413546008576,Fri Sep 29 02:44:55 +0000 2017,Moon Base Alpha https://t.co/voY8qEW9kl,14613,3641,18254,2017-09-29
2324,913547943646580737,Thu Sep 28 23:36:17 +0000 2017,Will be announcing something really special at today's talk https://t.co/plXTBJY6ia,22001,4944,26945,2017-09-28
2325,913547092194447360,Thu Sep 28 23:32:54 +0000 2017,"RT @SpaceX: Nine years ago today, Falcon 1 became the first privately developed liquid fuel rocket to orbit Earth. https://t.co/Aa0ITkuJET…",0,2707,2707,2017-09-28
2326,913489555663269889,Thu Sep 28 19:44:16 +0000 2017,@kevinroose Just another day in the office,7707,716,8423,2017-09-28
2327,913265477073428480,Thu Sep 28 04:53:52 +0000 2017,@Fashionista_com @mayemusk Congrats Mom! I love you.,10289,507,10796,2017-09-28
2328,913265363265220609,Thu Sep 28 04:53:24 +0000 2017,"RT @mayemusk: .@covergirl I'm so excited to say that I'm now officially a COVERGIRL, at 69! Beauty is for all ages. #COVERGIRLMADE https://…",0,1333,1333,2017-09-28
2329,912833915475386368,Wed Sep 27 00:18:59 +0000 2017,"Prev ideas for paying ~$10B dev cost incl. Kickstarter &amp; collecting underpants, which turned out to be um... less lucrative than expected",11576,1125,12701,2017-09-27
2330,912829943301754880,Wed Sep 27 00:03:12 +0000 2017,Headed to Adelaide soon to describe new BFR planetary colonizer design in detail @IAC2017. This should be worth seeing. Design feels right.,10799,1698,12497,2017-09-27
2331,912649053334265856,Tue Sep 26 12:04:25 +0000 2017,"@El_Deano @Daimler @Jalopnik Yes, I did :)",20163,2004,22167,2017-09-26
2332,912506866919288833,Tue Sep 26 02:39:25 +0000 2017,Good NYT article from several years ago about the value of fiction https://t.co/lVg7T0h7zG,7886,1970,9856,2017-09-26
2333,912470245318656000,Tue Sep 26 00:13:54 +0000 2017,@AdrianZorrillaC Yes,646,28,674,2017-09-26
2334,912469761686110209,Tue Sep 26 00:11:58 +0000 2017,Simulation of how the SpaceX Interplanetary Spaceship and Rocket design would work. Will be… https://t.co/yWYDxtAKQP,11982,2866,14848,2017-09-26
2335,912384568790999040,Mon Sep 25 18:33:27 +0000 2017,@Daimler Good,6844,652,7496,2017-09-25
2336,912259150175813633,Mon Sep 25 10:15:05 +0000 2017,Major improvements &amp; some unexpected applications to be unveiled on Friday at @IAC2017 in Australia,11120,1605,12725,2017-09-25
2337,912258562293825541,Mon Sep 25 10:12:44 +0000 2017,Presentation of @SpaceX Interplanetary Spaceship &amp; Rocket design from 2016 https://t.co/3b1YWWmmxg,6543,1298,7841,2017-09-25
2338,912036765287845888,Sun Sep 24 19:31:24 +0000 2017,@USATODAYmoney @NathanBomey That's not a lot of money for a giant like Daimler/Mercedes. Wish they'd do more. Off by a zero.,21689,3348,25037,2017-09-24
2339,911010134557462528,Thu Sep 21 23:31:56 +0000 2017,"RT @MotorTrend: Shocking winner of our latest, World's Greatest Drag Race 7! Maybe even #ludicrous? #WGDR7 https://t.co/ImvNAm2Yop",0,2140,2140,2017-09-21
2340,910540337935826944,Wed Sep 20 16:25:08 +0000 2017,"@Its_Subhamk Don't give up if the cause is important enough, even if you believe you are walking into doom. Good friends really matter.",18098,4218,22316,2017-09-20
2341,910180847814197248,Tue Sep 19 16:36:39 +0000 2017,"@JimHeaney Absolutely. Moreover, we expect to expand the facility significantly over time.",1636,94,1730,2017-09-19
2342,908937508884332544,Sat Sep 16 06:16:04 +0000 2017,@Richwsadler Does my hivemind count as me?,9697,407,10104,2017-09-16
2343,908877302418726912,Sat Sep 16 02:16:49 +0000 2017,@Bobby_Gupta Def not ok. Just sent a reminder to Tesla stores that we just want people to look forward to their nex… https://t.co/z4KuEhvl4a,10522,429,10951,2017-09-16
2344,908849937848221696,Sat Sep 16 00:28:05 +0000 2017,@rishabagrwl2013 In discussions with national govt. Just need a temporary reprieve on local content requirements un… https://t.co/sN53qoOckf,612,120,732,2017-09-16
2345,908847858509479936,Sat Sep 16 00:19:49 +0000 2017,@JayCruicks_ATC What if we just made a mini version of the Tesla Semi?,791,74,865,2017-09-16
2346,908715328112271360,Fri Sep 15 15:33:11 +0000 2017,@bonnienorman Of course :),1480,34,1514,2017-09-15
2347,908254739825025025,Thu Sep 14 09:02:59 +0000 2017,High res version at https://t.co/YysKftHhoz,8948,2487,11435,2017-09-14
2348,908254645809692672,Thu Sep 14 09:02:36 +0000 2017,@jovanik21 Most of it,1099,31,1130,2017-09-14
2349,908254079092002816,Thu Sep 14 09:00:21 +0000 2017,"Long road to reusabity of Falcon 9 primary boost stage…When upper stage &amp; fairing also reusable, costs will drop by… https://t.co/omqxEl6hCU",32174,9901,42075,2017-09-14
2350,908163652661927937,Thu Sep 14 03:01:02 +0000 2017,@simcrook @SmileSimplify Actually ... yes,478,23,501,2017-09-14
2351,908108029777686528,Wed Sep 13 23:20:00 +0000 2017,Tesla Semi truck unveil &amp; test ride tentatively scheduled for Oct 26th in Hawthorne. Worth seeing this beast in person. It's unreal.,72258,15175,87433,2017-09-13
2352,908073465319587840,Wed Sep 13 21:02:39 +0000 2017,@SmileSimplify Promise to be as boring as possible!,2427,131,2558,2017-09-13
2353,908067956361379846,Wed Sep 13 20:40:46 +0000 2017,"RT @FastCompany: During Irma’s power outages, some houses kept the lights on with solar and batteries https://t.co/OHDMawHI0A https://t.co/…",0,2087,2087,2017-09-13
2354,907543394787893248,Tue Sep 12 09:56:21 +0000 2017,RT @Gizmodo: Hackers have already started to weaponize artificial intelligence https://t.co/x7WfEYJLOv https://t.co/gshNLUKSyi,0,2160,2160,2017-09-12
2355,907483778603294720,Tue Sep 12 05:59:27 +0000 2017,@hohocho Yes,4220,231,4451,2017-09-12
2356,907476122719227904,Tue Sep 12 05:29:02 +0000 2017,RT @TeslaMotors: Supercharging Cities https://t.co/IGK9FasWDa,0,2150,2150,2017-09-12
2357,907407613930827777,Tue Sep 12 00:56:48 +0000 2017,@_vinouz_ @Reza_Zadeh Exactly,191,12,203,2017-09-12
2358,906274454946402304,Fri Sep 08 21:54:02 +0000 2017,Astronaut spacesuit next to Crew Dragon https://t.co/Csmgx8Nn0t,18695,4320,23015,2017-09-08
2359,905910267262926848,Thu Sep 07 21:46:53 +0000 2017,RT @SpaceX: More photos from today’s Falcon 9 launch and first stage landing → https://t.co/095WHWMtKp https://t.co/TpFnWS9GI9,0,3456,3456,2017-09-07
2360,905592538609852416,Thu Sep 07 00:44:20 +0000 2017,RT @TeslaMotors: Our new Supercharger route in South Australia will soon allow Tesla owners to visit the world's largest battery site https…,0,851,851,2017-09-07
2361,904764676118011905,Mon Sep 04 17:54:43 +0000 2017,"@SmileSimplify Fun, exciting tweets coming soon!",774,50,824,2017-09-04
2362,904764437281685504,Mon Sep 04 17:53:46 +0000 2017,@SmileSimplify Sorry about that. You're right. I was depressing myself too :(,480,21,501,2017-09-04
2363,904656511334354948,Mon Sep 04 10:44:54 +0000 2017,"@AndrewKemendo Govts don't need to follow normal laws. They will obtain AI developed by companies at gunpoint, if necessary.",2407,919,3326,2017-09-04
2364,904641970349285376,Mon Sep 04 09:47:07 +0000 2017,@ItchGrid Should be low on our list of concerns for civilizational existential risk. NK has no entangling alliances… https://t.co/aFUetANTvB,728,111,839,2017-09-04
2365,904640183932301312,Mon Sep 04 09:40:01 +0000 2017,"@SethicusGP NK launching a nuclear missile would be suicide for their leadership, as SK, US and China wd invade and… https://t.co/lmbkjRsucC",1165,214,1379,2017-09-04
2366,904639405440323585,Mon Sep 04 09:36:56 +0000 2017,"@JakeBlueatSM May be initiated not by the country leaders, but one of the AI's, if it decides that a prepemptive st… https://t.co/Ydj22p10gq",5855,1707,7562,2017-09-04
2367,904638455761612800,Mon Sep 04 09:33:09 +0000 2017,"China, Russia, soon all countries w strong computer science. Competition for AI superiority at national level most likely cause of WW3 imo.",46129,18312,64441,2017-09-04
2368,904633522161278977,Mon Sep 04 09:13:33 +0000 2017,@WendyWednesday8 Zeroth Law,574,29,603,2017-09-04
2369,904633084309422080,Mon Sep 04 09:11:49 +0000 2017,It begins ... https://t.co/mbjw5hWC5J,85833,35818,121651,2017-09-04
2370,903333005527093248,Thu Aug 31 19:05:46 +0000 2017,"Putting together SpaceX rocket landing blooper reel. We messed up a lot before it finally worked, but there's some epic explosion footage …",42931,5425,48356,2017-08-31
2371,903332343108091904,Thu Aug 31 19:03:08 +0000 2017,"@GigarothPack Not a bad idea. For sure, it makes sense to test AI for safety in some kind of open world / sandbox virtual world.",2380,130,2510,2017-08-31
2372,903132822700867586,Thu Aug 31 05:50:18 +0000 2017,@DMC_Ryan In about six months or so. Linked to dual motor config.,1463,88,1551,2017-08-31
2373,903129182397374464,Thu Aug 31 05:35:51 +0000 2017,We took the SpaceX/Tesla Hyperloop pusher pod for a spin by itself a few days ago to see what it… https://t.co/4hr1yN37he,19045,2224,21269,2017-08-31
2374,903120412007047169,Thu Aug 31 05:01:00 +0000 2017,@eKanishka @ChaseBlackmon1 @boringcompany Tunnels are sealed to 5 atmospheres of water &amp; gas pressure. Just need walls around the apertures.,243,17,260,2017-08-31
2375,903014801458085888,Wed Aug 30 22:01:20 +0000 2017,RT @karpathy: We're hiring strong ML/CV/Roboticists for the Tesla Autopilot Vision team. We ship autonomy at scale. Join us: vision@tesla.c…,0,1153,1153,2017-08-30
2376,902913054723022850,Wed Aug 30 15:17:02 +0000 2017,"@ChaseBlackmon1 @boringcompany Not sure, but probably",3153,148,3301,2017-08-30
2377,902912866335956994,Wed Aug 30 15:16:17 +0000 2017,@nickg_uk @Model3Owners Feature coming soon,681,46,727,2017-08-30
2378,902810547384496128,Wed Aug 30 08:29:42 +0000 2017,@AdolfOosthuizen They're so real. Anyone going to that much trouble must really care. I'd gladly follow their comma… https://t.co/l4PGniSimd,1503,122,1625,2017-08-30
2379,902801948944031744,Wed Aug 30 07:55:32 +0000 2017,@GraduateMonkey That's pretty much why we did it,2920,132,3052,2017-08-30
2380,902452162625544193,Tue Aug 29 08:45:36 +0000 2017,"Worth reading Life 3.0 by @Tegmark. AI will be the best or worst thing ever for humanity, so let’s get it right.
https://t.co/lT0uMH3ujZ",15908,3757,19665,2017-08-29
2381,902241473311105024,Mon Aug 28 18:48:24 +0000 2017,@bryanclark Hyperloop (near) vacuum tube runs parallel to SpaceX on Jack Northrop Blvd. It is 0.8 miles long and ju… https://t.co/Fjxur2tLAy,1738,92,1830,2017-08-28
2382,902206719094169600,Mon Aug 28 16:30:18 +0000 2017,"To be clear, a Hyperloop passenger version wouldn't have intense light strobe effect (just for testing), nor uncomfortable acceleration",14517,1255,15772,2017-08-28
2383,902088566494314496,Mon Aug 28 08:40:48 +0000 2017,@ItchGrid Brakes,20294,3244,23538,2017-08-28
2384,902088347840950274,Mon Aug 28 08:39:56 +0000 2017,@newscientist https://t.co/mA8ZgutrbE,394,40,434,2017-08-28
2385,902087339010211840,Mon Aug 28 08:35:56 +0000 2017,Will run the SpaceX pusher sled later this week and see what it can do,9467,787,10254,2017-08-28
2386,902086852152254464,Mon Aug 28 08:34:00 +0000 2017,"@newscientist Moon base alpha (cheesy show, but I loved it) plus Mars",1572,85,1657,2017-08-28
2387,902078189891026945,Mon Aug 28 07:59:34 +0000 2017,"@bfslandinglegs @RichardFPenn @John_Gardi Not that this is remotely equiv to man on the moon, but there is a world… https://t.co/Kfi9AzVzcM",814,60,874,2017-08-28
2388,902077101334904834,Mon Aug 28 07:55:15 +0000 2017,"@bfslandinglegs @RichardFPenn @John_Gardi Actually, no, his architecture was different. Also, thinking of going to… https://t.co/qgHzBts3zs",745,32,777,2017-08-28
2389,902039243601485824,Mon Aug 28 05:24:49 +0000 2017,Hyperloop pod run by team WARR https://t.co/ntaMsoxkZE,128159,46843,175002,2017-08-28
2390,902036110129250304,Mon Aug 28 05:12:22 +0000 2017,"@Excellion @boringcompany @OpenAI The AI could def find us there, but maybe it won't care",302,18,320,2017-08-28
2391,902033084115283968,Mon Aug 28 05:00:20 +0000 2017,A Model S in The Boring Company tunnel being dug under Los Angeles (starting in Hawthorne) https://t.co/tQVD5KkIvb,6932,995,7927,2017-08-28
2392,902005089300242432,Mon Aug 28 03:09:06 +0000 2017,"@PiPrefer Yes, it is",445,12,457,2017-08-28
2393,901984719444688896,Mon Aug 28 01:48:09 +0000 2017,@JRoque250 @Freewill404 @cbotnyse A tiny one,384,11,395,2017-08-28
2394,901984394264494080,Mon Aug 28 01:46:52 +0000 2017,"Btw, high accel only needed because tube is short. For passenger transport, this can be spread over 20+ miles, so no spilt drinks.",11950,865,12815,2017-08-28
2395,901975117797851137,Mon Aug 28 01:10:00 +0000 2017,"@Freewill404 @cbotnyse No such thing as true vacuum, so actually yes",342,12,354,2017-08-28
2396,901970991332564992,Mon Aug 28 00:53:36 +0000 2017,@cbotnyse Call it ~800mph,766,47,813,2017-08-28
2397,901970722343444480,Mon Aug 28 00:52:32 +0000 2017,"Might be possible to go supersonic in our test Hyperloop tube, even though it's only 0.8 miles long. Very high accel/decel needed …",24036,3057,27093,2017-08-28
2398,901965739745148929,Mon Aug 28 00:32:44 +0000 2017,"Congratulations to WARR team from Tech Univ Munich for winning 2nd @Hyperloop competition! Peak speed of 324 km/h, which is over 200 mph!!",9595,1563,11158,2017-08-28
2399,901930363118747650,Sun Aug 27 22:12:10 +0000 2017,Just arrived at the @Hyperloop competition final. Student teams have amazing talent!,10695,829,11524,2017-08-27
2400,901929826918981636,Sun Aug 27 22:10:02 +0000 2017,@OfficeOfOMAR @HyperloopOne I hope they and any others trying to advance transport technology succeed,696,34,730,2017-08-27
2401,901904930071609345,Sun Aug 27 20:31:06 +0000 2017,@SmileSimplify @Vita_Berlin @c12olivas Exactly. Wouldn't let anyone invest more than a token amount in early rounds… https://t.co/PIsJq5n19E,302,20,322,2017-08-27
2402,901904354126520321,Sun Aug 27 20:28:49 +0000 2017,https://t.co/IypZm9FdQk,9236,4441,13677,2017-08-27
2403,901903526061907969,Sun Aug 27 20:25:31 +0000 2017,"@SU3UR3ANLegend Sorry! Coming next year, along with completing the Trans-Canada Highway and interconnecting US, Mexico and Central America.",2868,198,3066,2017-08-27
2404,901902674853068802,Sun Aug 27 20:22:08 +0000 2017,"@bobbyblackstock @c12olivas Funny thing is, whenever I suggest all companies go to zero incentives, room gets very… https://t.co/6eQMYnWrUX",511,65,576,2017-08-27
2405,901902181657448448,Sun Aug 27 20:20:11 +0000 2017,@bobbyblackstock @c12olivas Literally zero incentive laws were put into place by my companies. Zero. Others put the… https://t.co/fqZUBnbGEu,426,42,468,2017-08-27
2406,901889875867205632,Sun Aug 27 19:31:17 +0000 2017,@c12olivas I'm not an investor. Just believe in putting money into my own companies. Don't think the OPM approach is right.,2919,215,3134,2017-08-27
2407,901887665662025728,Sun Aug 27 19:22:30 +0000 2017,@SmileSimplify @beboutside @Hyperloop @SpaceX @paradigm_hype @swissloop The latter. There are pretty long gaps betw… https://t.co/lnrzgxmwV7,270,8,278,2017-08-27
2408,901875780556226560,Sun Aug 27 18:35:16 +0000 2017,"From last year, but still my favorite video of the Falcon 9 rocket booster returning from space… https://t.co/b935pdz2Xi",8507,1581,10088,2017-08-27
2409,901871305124864000,Sun Aug 27 18:17:29 +0000 2017,@beboutside @Hyperloop @SpaceX @paradigm_hype @swissloop SpaceX and The Boring Company are running the Hyperloop competition,391,27,418,2017-08-27
2410,901870435628810241,Sun Aug 27 18:14:02 +0000 2017,"RT @Hyperloop: Top 3 teams launching their pods on the ~mile long vacuum track at @SpaceX’s HQ today: @paradigm_hype, @swissloop and WARR H…",0,418,418,2017-08-27
2411,901238166237069313,Sat Aug 26 00:21:37 +0000 2017,"@Techmeme Tesla does not really have ""TTunes"". That's a joke.",1153,110,1263,2017-08-26
2412,901236337281454081,Sat Aug 26 00:14:21 +0000 2017,"@kateconger Will be hanging with my little chum, Gary, on Sunday",1169,33,1202,2017-08-26
2413,901162747865333760,Fri Aug 25 19:21:56 +0000 2017,@RolfeWinkler @julieverhage Let me check on that for you. Found the answer right here: 🔥💩,522,67,589,2017-08-25
2414,901162339663175680,Fri Aug 25 19:20:19 +0000 2017,@alexeheath @RolfeWinkler @julieverhage It was misinterpreted by Rolfe at WSJ as a fundraising effort. Neuralink is not seeking investors.,238,15,253,2017-08-25
2415,901161712950272000,Fri Aug 25 19:17:49 +0000 2017,@berlinhedgehog @jmackin2 WSJ has been laboriously negative for over a decade. I'm surprised they haven't bored the… https://t.co/p5L3JIz2UM,449,68,517,2017-08-25
2416,901160950564216832,Fri Aug 25 19:14:48 +0000 2017,@RolfeWinkler @julieverhage Neuralink is not raising money,281,30,311,2017-08-25
2417,900994666660626432,Fri Aug 25 08:14:02 +0000 2017,"Max recovered booster velocity was Mach 7.9 (BulgarianSat). Energy is velocity squared, so this is a bigger difference than it appears",6675,555,7230,2017-08-25
2418,900958153533042689,Fri Aug 25 05:48:57 +0000 2017,"Max velocity: Mach 6.9
Max altitude: 247 km
Highest so far, but velocity matters much more",9601,915,10516,2017-08-25
2419,900954066292924417,Fri Aug 25 05:32:42 +0000 2017,@rupertdance @VoltzCoreAudio Probably 2m or so,337,10,347,2017-08-25
2420,900953175594639360,Fri Aug 25 05:29:10 +0000 2017,@VoltzCoreAudio Exactly. Yeah.,452,14,466,2017-08-25
2421,900952880118603777,Fri Aug 25 05:28:00 +0000 2017,@sroalf Intentionally? Yes,286,8,294,2017-08-25
2422,900952521560121350,Fri Aug 25 05:26:34 +0000 2017,@HarshilShah1910 It is approximately the size of a carrot,957,71,1028,2017-08-25
2423,900951975671373824,Fri Aug 25 05:24:24 +0000 2017,"Touchdown:
Vertical Velocity (m/s): -1.47 
Lateral Velocity  (m/s): -0.15 
Tilt (deg):  0.40 ​
Lateral position: 0.7m from target center",13781,1456,15237,2017-08-25
2424,900947535358967808,Fri Aug 25 05:06:45 +0000 2017,Falcon 9 boost stage on droneship Just Read the Instructions https://t.co/fZTPmwsnOz,31020,4505,35525,2017-08-25
2425,900812511267520512,Thu Aug 24 20:10:13 +0000 2017,RT @SpaceX: Successful deployment of FORMOSAT-5 to low-Earth orbit confirmed. https://t.co/PiB7r3Zk4F,0,1888,1888,2017-08-24
2426,900466867659198464,Wed Aug 23 21:16:45 +0000 2017,"A midnight amendment, followed by a vigorously opposed subpoena. Someone has been naughty …
https://t.co/RJeiNJngGt",10110,1680,11790,2017-08-23
2427,900461716617674752,Wed Aug 23 20:56:17 +0000 2017,@vorbildgroup I played those games :),1247,95,1342,2017-08-23
2428,900429498838994944,Wed Aug 23 18:48:16 +0000 2017,"@DiscoverMag That's a SpaceX engineer in there, not me",7919,452,8371,2017-08-23
2429,900413265313792000,Wed Aug 23 17:43:45 +0000 2017,New Model X SUV now faster than a $500k Lamborghini https://t.co/J23AKNMnmV,35909,9989,45898,2017-08-23
2430,900376843210981378,Wed Aug 23 15:19:02 +0000 2017,"@KonstDubbed Yeah. It's kinda disgusting, but my boys and I love it :)",11586,1359,12945,2017-08-23
2431,900369251004850176,Wed Aug 23 14:48:52 +0000 2017,RT @Teslarati: Tesla unlocks ‘Level 2’ referral program prize: Drive an electric tunnel boring machine with The Boring Company - https://t.…,0,414,414,2017-08-23
2432,900363626841812992,Wed Aug 23 14:26:31 +0000 2017,First picture of SpaceX spacesuit. More in days to follow. Worth noting that this actually works… https://t.co/5ZtqkKiTQX,33454,10859,44313,2017-08-23
2433,899923514576084992,Tue Aug 22 09:17:40 +0000 2017,"@BlueRhythmics I would say that @TheOnion is the greatest publication in the history of all conscious beings, living or dead",1291,178,1469,2017-08-22
2434,899917256372633600,Tue Aug 22 08:52:48 +0000 2017,"@ricky_errera I'm not the CEO of Ball Mason Jars. Also, not judging …",504,18,522,2017-08-22
2435,899916632830525440,Tue Aug 22 08:50:19 +0000 2017,Was at a friend's party this weekend and drank wine from a mason jar https://t.co/eMs7MbNJep,4893,670,5563,2017-08-22
2436,899872164106481664,Tue Aug 22 05:53:37 +0000 2017,@brijwaasi I can't hide the truth any more …,34800,5764,40564,2017-08-22
2437,899710778671902720,Mon Aug 21 19:12:20 +0000 2017,"RT @cmleahey: Mars is looking pretty good right now, no? Meet the woman (@elonmusk's right hand @SpaceX ) working to get us there https://t…",0,790,790,2017-08-21
2438,899701180674187265,Mon Aug 21 18:34:11 +0000 2017,@theafterpipe Yes :),1727,58,1785,2017-08-21
2439,899682569951760384,Mon Aug 21 17:20:14 +0000 2017,Watching eclipse with sunglasses on through the Model S glass roof. Wow!,43332,4348,47680,2017-08-21
2440,899490321431764992,Mon Aug 21 04:36:19 +0000 2017,SpaceX rocket factory as seen from space https://t.co/JNsvMsNvQX,9580,1226,10806,2017-08-21
2441,899224620510830592,Sun Aug 20 11:00:30 +0000 2017,"@geerinckx1989 Yeah, but not a priority right now",2253,61,2314,2017-08-20
2442,899215699389759488,Sun Aug 20 10:25:04 +0000 2017,@SeeDecentral @technology I'm not coming for anything. Just digging some tunnels and might draw a vacuum on some of them.,432,25,457,2017-08-20
2443,899215300901519360,Sun Aug 20 10:23:29 +0000 2017,"@dfchil We are going to move all info and settings to the ""cloud"" (aka server) so any Tesla you drive in the world… https://t.co/V9ZzN6IN3O",8071,976,9047,2017-08-20
2444,899075756508065793,Sun Aug 20 01:08:59 +0000 2017,Pics of SpaceX spacesuit developed for NASA commercial crew program coming out next week. Undergoing ocean landing mobility/safety tests.,30089,4221,34310,2017-08-20
2445,899018076867272704,Sat Aug 19 21:19:47 +0000 2017,@mbianchi @andrewket Totally agree. This was a foolish oversight.,308,6,314,2017-08-19
2446,899017770787979265,Sat Aug 19 21:18:34 +0000 2017,@WillFealey At some point. Features are prioritized by importance * number of owners likely to benefit.,870,29,899,2017-08-19
2447,899017475366412288,Sat Aug 19 21:17:23 +0000 2017,@Dem0ney Yeah. That's been on the future feature list for a while. Need to make sure rain sensor doesn't false positive or drain battery.,3790,149,3939,2017-08-19
2448,899015841160679424,Sat Aug 19 21:10:54 +0000 2017,@_jeffreyr @ThePhoenixFlare @Cupen_Ames @pjfranks1509 Will prob do something like that,181,4,185,2017-08-19
2449,899003841001037824,Sat Aug 19 20:23:13 +0000 2017,@RanRinBC @Cupen_Ames @pjfranks1509 Problem is possible impact on curbs or ground objects with the car itself or door swing arc,183,7,190,2017-08-19
2450,898997621158690816,Sat Aug 19 19:58:30 +0000 2017,"@andrewket Will do. Also, we need to make it a lot easier to adjust the headrest.",2205,48,2253,2017-08-19
2451,898782234701737984,Sat Aug 19 05:42:37 +0000 2017,"@Cupen_Ames @pjfranks1509 Yeah, it should probably automatically adjust to the user config of whoever is closest to… https://t.co/1B19Da6OLZ",429,29,458,2017-08-19
2452,898713949125787650,Sat Aug 19 01:11:17 +0000 2017,@pjfranks1509 Good point. We will add that to all cars in one of the upcoming software releases.,9189,494,9683,2017-08-19
2453,898659784307515392,Fri Aug 18 21:36:03 +0000 2017,@robcrawford08 I love Kermit,27187,3374,30561,2017-08-18
2454,898523896952922113,Fri Aug 18 12:36:05 +0000 2017,"But you can check it out on @9GAGTweets. Btw, this isn't a video, like cliff diving or fake rocket landings, that matters if it's reversed.",2344,165,2509,2017-08-18
2455,898522857847652353,Fri Aug 18 12:31:57 +0000 2017,Wigs me out too much. Deleting ...,2377,135,2512,2017-08-18
2456,897234747025313793,Mon Aug 14 23:13:28 +0000 2017,"@PatricknLA @ericgarcetti Yes, just that the permitting process is slow",633,30,663,2017-08-14
2457,897234526945988608,Mon Aug 14 23:12:35 +0000 2017,@Schmidtlaxer I want one too!,825,29,854,2017-08-14
2458,897232757629173760,Mon Aug 14 23:05:33 +0000 2017,"Tesla Powerwalls can support houses of any size, but the cool thing is we can tow this house around with a Model X! https://t.co/MmQl8BPetY",23085,4634,27719,2017-08-14
2459,897223001631899648,Mon Aug 14 22:26:47 +0000 2017,"@neddesmond @SpaceX The danger is def high for South Korea, due to proximity, but much less for distant targets lik… https://t.co/H6w2W9Mage",402,38,440,2017-08-14
2460,897221108704751616,Mon Aug 14 22:19:16 +0000 2017,"@neddesmond @SpaceX We certainly could, but, while not suggesting complacency, I'm confident that the US DoD and in… https://t.co/81HxzmMZBC",2862,196,3058,2017-08-14
2461,897180786708721664,Mon Aug 14 19:39:03 +0000 2017,RT @SpaceX: Quick video recap of Falcon 9 launch of Dragon for its twelfth @Space_Station resupply mission. https://t.co/BNx5mVBA4c https:/…,0,7216,7216,2017-08-14
2462,897143162363297792,Mon Aug 14 17:09:32 +0000 2017,RT @NASA: Science &amp; supplies are headed to the @Space_Station following the 12:31pm ET launch of @SpaceX's #Dragon spacecraft: https://t.co…,0,1055,1055,2017-08-14
2463,897142164731199488,Mon Aug 14 17:05:34 +0000 2017,12th mission of our Dragon robotic space freighter in support of the @NASA @Space_Station https://t.co/vlGbGLgBcR,14613,2216,16829,2017-08-14
2464,896762461574938625,Sun Aug 13 15:56:46 +0000 2017,First draft animation of the Falcon Heavy three core launch. FH is twice the thrust of the next… https://t.co/vgZxF6ugoh,9588,1977,11565,2017-08-13
2465,896227859596955648,Sat Aug 12 04:32:27 +0000 2017,@Beryllium9 @jasontoff For sure,500,18,518,2017-08-12
2466,896226285831077888,Sat Aug 12 04:26:12 +0000 2017,@Reza_Zadeh Biggest impediment to recognizing AI danger are those so convinced of their own intelligence they can't… https://t.co/sjZNMZpF96,2405,502,2907,2017-08-12
2467,896216646670471168,Sat Aug 12 03:47:54 +0000 2017,Would like to express our appreciation to Microsoft for use of their Azure cloud computing platform. This required massive processing power.,19582,4158,23740,2017-08-12
2468,896200592388784128,Sat Aug 12 02:44:06 +0000 2017,OpenAI + Dota 2 https://t.co/hdyFSMMB0z,12998,4376,17374,2017-08-12
2469,896171308706287616,Sat Aug 12 00:47:44 +0000 2017,@VeryVandy It is far too complex for that. Requires a team of the world's best AI researchers with massive computing resources.,2000,190,2190,2017-08-12
2470,896169801277517824,Sat Aug 12 00:41:45 +0000 2017,"Nobody likes being regulated, but everything (cars, planes, food, drugs, etc) that's a danger to the public is regulated. AI should be too.",74099,20896,94995,2017-08-12
2471,896167360624590848,Sat Aug 12 00:32:03 +0000 2017,"@iainthomson I sure hope so, but we can't take that for granted",385,8,393,2017-08-12
2472,896166762361704450,Sat Aug 12 00:29:40 +0000 2017,"If you're not concerned about AI safety, you should be. Vastly more risk than North Korea. https://t.co/2z0tiid0lc",37356,13259,50615,2017-08-12
2473,896163163581825025,Sat Aug 12 00:15:22 +0000 2017,OpenAI first ever to defeat world's best players in competitive eSports. Vastly more complex than traditional board games like chess &amp; Go.,38219,11109,49328,2017-08-12
2474,896161824755732480,Sat Aug 12 00:10:03 +0000 2017,RT @OpenAI: Our Dota 2 AI is undefeated against the world's best solo players: https://t.co/cUvTbGW7ya,0,2481,2481,2017-08-12
2475,896161767247683584,Sat Aug 12 00:09:49 +0000 2017,"RT @OpenAI: In a few minutes, watch our Dota 2 AI play live on main stage at The International: https://t.co/mjTTPTlPh5",0,903,903,2017-08-12
2476,895878249389072386,Fri Aug 11 05:23:13 +0000 2017,@SmileSimplify @VatsalSngh @businessinsider Coming soon ...,339,9,348,2017-08-11
2477,895872939286872068,Fri Aug 11 05:02:07 +0000 2017,@mayemusk Hi Mom!,11127,665,11792,2017-08-11
2478,895867074517516289,Fri Aug 11 04:38:49 +0000 2017,@maralkalajian @businessinsider A level 9 orc illusionist and dressmaker,1192,105,1297,2017-08-11
2479,895866249669820418,Fri Aug 11 04:35:32 +0000 2017,@TIME This is about as true as TIME being a paragon of great journalism. Please spend at least 8 seconds checking your facts.,31701,5424,37125,2017-08-11
2480,895865506602692609,Fri Aug 11 04:32:35 +0000 2017,@businessinsider Just because I have the outfit and the awesome weapons doesn't make me a ninja. That requires years of training.,1133,176,1309,2017-08-11
2481,895864765980958721,Fri Aug 11 04:29:39 +0000 2017,@VatsalSngh @businessinsider There are dozens of bogus or half-true anecdotes don't really matter &amp; maybe 5 to 10 t… https://t.co/xMThhVbct9,487,16,503,2017-08-11
2482,895838512544702465,Fri Aug 11 02:45:19 +0000 2017,@businessinsider One other I'd like to correct from the biography: I never said I was a samurai. Said I was ninja.… https://t.co/xYoGctHBas,5363,486,5849,2017-08-11
2483,895837913707163648,Fri Aug 11 02:42:57 +0000 2017,@businessinsider MB was given 52 weeks of salary &amp; stock in appreciation for her great contribution &amp; left to join… https://t.co/m3nHHpVbFe,1435,189,1624,2017-08-11
2484,895836885427335168,Fri Aug 11 02:38:51 +0000 2017,"@businessinsider Mary Beth was an amazing assistant for over 10 yrs, but as company complexity grew, the role requi… https://t.co/vCjSfdLFKt",1044,138,1182,2017-08-11
2485,895835433363439616,Fri Aug 11 02:33:05 +0000 2017,"@businessinsider Of all the bogus anecdotes, this one troubles me the most. Ashlee never actually ran this story by… https://t.co/8j0bUnqp1p",984,131,1115,2017-08-11
2486,895834554245709824,Fri Aug 11 02:29:36 +0000 2017,"@businessinsider Ashlee Vance's biography is mostly correct, but also rife with errors &amp; never independently fact-c… https://t.co/ReXTSXqqwz",2997,322,3319,2017-08-11
2487,895512698145976320,Thu Aug 10 05:10:39 +0000 2017,@LWRGI Major increases in the Supercharger and Tesla urban charger network happening over the next several months,4002,325,4327,2017-08-10
2488,894346282642354178,Sun Aug 06 23:55:44 +0000 2017,First draft animation of the Falcon Heavy three core launch. FH is twice the thrust of the next… https://t.co/vgZxF6LRMR,13128,2990,16118,2017-08-06
2489,894323936413929472,Sun Aug 06 22:26:56 +0000 2017,@AmirNoir I agree. Working on it ...,2319,93,2412,2017-08-06
2490,893995253392326656,Sun Aug 06 00:40:52 +0000 2017,@AwarenessReef @lexiheft @Domenick_Y @bonnienorman It's only a matter of time,375,16,391,2017-08-06
2491,893995091399856128,Sun Aug 06 00:40:14 +0000 2017,@Belakorr y,4363,304,4667,2017-08-06
2492,893993947881652224,Sun Aug 06 00:35:41 +0000 2017,"True, although the changemyview subreddit is least likely to be clicked on by people who really should change their… https://t.co/t8Aijwo9TH",7390,898,8288,2017-08-06
2493,893988268655525888,Sun Aug 06 00:13:07 +0000 2017,"Arguments, followed, of course, by complaints https://t.co/DOOWMGy8p8",4684,723,5407,2017-08-06
2494,893985648402497536,Sun Aug 06 00:02:42 +0000 2017,@iDedupe Are you complaining that we are not complaining enough?,2372,112,2484,2017-08-06
2495,893985049569185792,Sun Aug 06 00:00:19 +0000 2017,@Domenick_Y @bonnienorman And let's not forget the forum on which we are posting… I've heard - now this is just a r… https://t.co/atTchL0CLN,961,68,1029,2017-08-06
2496,893983388729618433,Sat Aug 05 23:53:43 +0000 2017,@TomDines Like I said ...,1123,20,1143,2017-08-05
2497,893982616692465664,Sat Aug 05 23:50:39 +0000 2017,@bonnienorman It gets really dark,364,13,377,2017-08-05
2498,893982228857761794,Sat Aug 05 23:49:07 +0000 2017,"@WaywardPlane True, there are frequent complaint expansion packs",723,26,749,2017-08-05
2499,893981677437018113,Sat Aug 05 23:46:55 +0000 2017,Except for complaining. That has remained constant throughout history at 100/100. https://t.co/dQFlVLkO21,33958,10905,44863,2017-08-05
2500,893920554821931008,Sat Aug 05 19:44:03 +0000 2017,Officially verified as the first production electric car to exceed 1000km on a single charge! Congratulations Tesla… https://t.co/B7umKT455U,52818,14806,67624,2017-08-05
2501,893416227967717376,Fri Aug 04 10:20:02 +0000 2017,@GuardianSustBiz I guess a proof of concept is needed,10452,766,11218,2017-08-04
2502,893176500005908482,Thu Aug 03 18:27:26 +0000 2017,"Looking forward to launching @NASA astronauts to the International Space Station next year!
https://t.co/qoLtTEP4L8",29055,6424,35479,2017-08-03
2503,892881718201401344,Wed Aug 02 22:56:05 +0000 2017,@RSorokanich @RoadandTrack Sorry about that. You certainly should have been. Will get you guys in a car right away.,2657,79,2736,2017-08-02
2504,892818841738158080,Wed Aug 02 18:46:14 +0000 2017,"@jdlien No, must brake safely to a halt",438,14,452,2017-08-02
2505,892811651824533504,Wed Aug 02 18:17:40 +0000 2017,SpaceX student Hyperloop top speed competition coming up soon! https://t.co/R7FAPf6HLB,15214,2674,17888,2017-08-02
2506,892545286748258305,Wed Aug 02 00:39:13 +0000 2017,We poured our heart into the car. Hope you love it. https://t.co/DZOgQUfENo,35348,5720,41068,2017-08-02
2507,892216736497319936,Tue Aug 01 02:53:41 +0000 2017,Sure hope so https://t.co/VJclNI3I2F,24192,3291,27483,2017-08-01
2508,892083176897626113,Mon Jul 31 18:02:58 +0000 2017,@FoxNews Batteries!,9888,710,10598,2017-07-31
2509,892049271511330816,Mon Jul 31 15:48:14 +0000 2017,"Thoughtful Model 3 review by @tsrandall, one of the most insightful journalists https://t.co/cuIKJ9NglN",10675,2721,13396,2017-07-31
2510,891925017461575680,Mon Jul 31 07:34:29 +0000 2017,"@SmileSimplify @notshahzeb @verge There are several dozen ship names in the Culture series, but I liked those best",1092,37,1129,2017-07-31
2511,891911665821786112,Mon Jul 31 06:41:26 +0000 2017,@verge Umm ... https://t.co/bjJ0lNYK35,49433,7671,57104,2017-07-31
2512,891737934553989120,Sun Jul 30 19:11:05 +0000 2017,"@skynetcomputer Yeah, it's better than a Model 3. We can put a lot more in a car at a higher price.",457,22,479,2017-07-30
2513,891719659514245121,Sun Jul 30 17:58:28 +0000 2017,"@robertgaal @EricDiepeveen I'm sure there are better answers than what I do, which is just take the pain and make s… https://t.co/d5uG6TAVgZ",2148,357,2505,2017-07-30
2514,891715134132936704,Sun Jul 30 17:40:29 +0000 2017,"@iFahadUddin @EricDiepeveen If you buy a ticket to hell, it isn't fair to blame hell ...",1096,368,1464,2017-07-30
2515,891714878494261249,Sun Jul 30 17:39:28 +0000 2017,"@iFahadUddin @EricDiepeveen Maybe not medically tho. Dunno. Bad feelings correlate to bad events, so maybe real pro… https://t.co/Eh26YGUZdO",1318,102,1420,2017-07-30
2516,891713104786083841,Sun Jul 30 17:32:26 +0000 2017,@iFahadUddin @EricDiepeveen Yeah,730,41,771,2017-07-30
2517,891710778205626368,Sun Jul 30 17:23:11 +0000 2017,"@EricDiepeveen The reality is great highs, terrible lows and unrelenting stress. Don't think people want to hear about the last two.",23913,6124,30037,2017-07-30
2518,891708792110317568,Sun Jul 30 17:15:17 +0000 2017,@cunarders Model 3 uses two intersecting planes of air for vertical control &amp; lateral fins hidden within the dashbo… https://t.co/BwltvXhaFe,987,106,1093,2017-07-30
2519,891704985603284992,Sun Jul 30 17:00:10 +0000 2017,Model 3 Interior https://t.co/fihY06dJLw,13779,2595,16374,2017-07-30
2520,891546920232943617,Sun Jul 30 06:32:04 +0000 2017,@NigeBe Yes,2013,52,2065,2017-07-30
2521,891543170160353283,Sun Jul 30 06:17:10 +0000 2017,@DMC_Ryan Probably middle of next year. Focus now is on getting out of Model 3 production hell. More versions = deeper in hell.,6144,365,6509,2017-07-30
2522,891441883179753472,Sat Jul 29 23:34:41 +0000 2017,@antplaysdrums Yes,3167,137,3304,2017-07-29
2523,891337229162790912,Sat Jul 29 16:38:50 +0000 2017,@Oatmeal Sure,799,42,841,2017-07-29
2524,891184274782670848,Sat Jul 29 06:31:03 +0000 2017,RT @MotorTrend: INTERGALACTIC EXCLUSIVE: FIRST DRIVE OF THE ALL-NEW @TeslaMotors #MODEL3 https://t.co/OAhM2geYnQ,0,3246,3246,2017-07-29
2525,891184052274778113,Sat Jul 29 06:30:10 +0000 2017,"RT @TeslaMotors: S, 3, X on a bridge https://t.co/2E57xqkTVY",0,11926,11926,2017-07-29
2526,891184033782255616,Sat Jul 29 06:30:05 +0000 2017,RT @TeslaMotors: Watch a Tesla Model 3 vs. Volvo S60 side-pole impact test https://t.co/dXBQkstrdo,0,8590,8590,2017-07-29
2527,891184009216118785,Sat Jul 29 06:29:59 +0000 2017,RT @TeslaMotors: Thank you to all our employees for your hard work making Model 3 a reality https://t.co/QctmioYxRw,0,2523,2523,2017-07-29
2528,891113180360880128,Sat Jul 29 01:48:32 +0000 2017,@TeslaOwnerClub Watched them personally to make sure &amp; I agree with the outcome. Wouldn't have judged differently.… https://t.co/fClZjlac2D,4549,302,4851,2017-07-29
2529,891108671828013056,Sat Jul 29 01:30:38 +0000 2017,Couldn't believe how incredibly inspiring and creative they were!!,11406,738,12144,2017-07-29
2530,891108125842878464,Sat Jul 29 01:28:27 +0000 2017,First! https://t.co/OXNEgDnhku,21166,3059,24225,2017-07-29
2531,891108035665338369,Sat Jul 29 01:28:06 +0000 2017,Second https://t.co/BTVNSZhC9z,5613,709,6322,2017-07-29
2532,891107966367158272,Sat Jul 29 01:27:49 +0000 2017,Third https://t.co/JAcuaLWTQY,4551,560,5111,2017-07-29
2533,891107800901853184,Sat Jul 29 01:27:10 +0000 2017,Project Loveday winners ...,5094,367,5461,2017-07-29
2534,891102762464714753,Sat Jul 29 01:07:09 +0000 2017,RT @TeslaMotors: Watch the first Model 3 handovers on https://t.co/7Ol1Bw0ZaG this Friday at 8:45pm PT https://t.co/b00OZGviNK,0,3423,3423,2017-07-29
2535,891076061475160064,Fri Jul 28 23:21:03 +0000 2017,"RT @mkarolian: Almost 11 years ago @elonmusk shared his ""master plan"" for @TeslaMotors. Tonight he delivers on the final step of it. https:…",0,4754,4754,2017-07-28
2536,890830152124563457,Fri Jul 28 07:03:53 +0000 2017,Setting up for Model 3 handover tomorrow night ... https://t.co/gcnZ5jTjyR,11630,1740,13370,2017-07-28
2537,890810366615146496,Fri Jul 28 05:45:16 +0000 2017,@Cardoso @Cosmic_Penguin @caradocp If we're lucky,688,28,716,2017-07-28
2538,890810308326940672,Fri Jul 28 05:45:02 +0000 2017,"@Cardoso @Cosmic_Penguin @caradocp Sides run high thrust, center is lower thrust until sides separate &amp; fly back. C… https://t.co/fgloD9Fsyw",568,62,630,2017-07-28
2539,890774088104370176,Fri Jul 28 03:21:07 +0000 2017,@caradocp Side booster rockets return to Cape Canaveral. Center lands on droneship.,984,146,1130,2017-07-28
2540,890765027032039429,Fri Jul 28 02:45:06 +0000 2017,Falcon Heavy maiden launch this November https://t.co/D4Dxq9d6hc,15345,3609,18954,2017-07-28
2541,890676198874824706,Thu Jul 27 20:52:08 +0000 2017,@mathetes76 Tesla team will verify,978,22,1000,2017-07-27
2542,890327644192907264,Wed Jul 26 21:47:06 +0000 2017,RT @Teslarati: Remembering some of our favorite Tesla Project Loveday videos. What's yours?https://t.co/1c0Uqjzva0 https://t.co/rptiWHGbS3,0,214,214,2017-07-26
2543,890324969363603456,Wed Jul 26 21:36:28 +0000 2017,RT @TeslaMotors: Watch all 10 Project Loveday finalists and like your favorites on Twitter by 5pm PT Friday: https://t.co/EhJvUdGFyc,0,677,677,2017-07-26
2544,890321733101658112,Wed Jul 26 21:23:37 +0000 2017,RT @guardianeco: Britain to ban sale of all diesel and petrol cars and vans from 2040 https://t.co/9LwhmHElzj,0,1672,1672,2017-07-26
2545,890096103135358982,Wed Jul 26 06:27:02 +0000 2017,Testing The Boring Company car elevator https://t.co/zZkFz6ATGY,16340,3375,19715,2017-07-26
2546,890048598611599360,Wed Jul 26 03:18:16 +0000 2017,Love this Tesla P100D drag racing video https://t.co/rxTTFOn8mp,14784,3250,18034,2017-07-26
2547,889751762944512002,Tue Jul 25 07:38:45 +0000 2017,@lars_0 @dcunni @SVbizjournal Movie on the subject coming soon...,3585,348,3933,2017-07-25
2548,889749519021121536,Tue Jul 25 07:29:50 +0000 2017,"Tim's piece on AI is excellent, but we actually face a double exponential rate of improvement. AI hardware &amp; softwa… https://t.co/JfLoHVCxMH",7939,2056,9995,2017-07-25
2549,889743782387761152,Tue Jul 25 07:07:03 +0000 2017,@dcunni @SVbizjournal I've talked to Mark about this. His understanding of the subject is limited.,35479,9180,44659,2017-07-25
2550,889743207684218880,Tue Jul 25 07:04:45 +0000 2017,@maralkalajian A book of the most beautiful classic cars given to me on my 18th birthday on a farm in Saskatchewan. Van Gogh's Starry Night.,791,54,845,2017-07-25
2551,889737700382605312,Tue Jul 25 06:42:52 +0000 2017,@NickHOrford $US price in $AUD plus import duties and sales tax,283,13,296,2017-07-25
2552,889736942564253696,Tue Jul 25 06:39:52 +0000 2017,@RyanBiddle603 @SpaceX We can't have too many direct shareholders or we're required to become a public co. Will che… https://t.co/95mIW9SWql,2442,129,2571,2017-07-25
2553,889736220116254721,Tue Jul 25 06:37:00 +0000 2017,Often comes as a surprise when people learn that 80% of my time is on engineering/design and just 20% on other stuff https://t.co/T9yLcg9owU,18537,3977,22514,2017-07-25
2554,888813713800785923,Sat Jul 22 17:31:17 +0000 2017,@VoltzCoreAudio @andygen21 @Teslarati A 9m diameter vehicle fits in our existing factories ...,656,81,737,2017-07-22
2555,888555494763241472,Sat Jul 22 00:25:13 +0000 2017,"@andygen21 @Teslarati Yes, I postponed publishing in order to present the updated interplanetary rocket &amp; spaceship… https://t.co/eyTev6VyTw",664,82,746,2017-07-22
2556,888541666122113024,Fri Jul 21 23:30:16 +0000 2017,Discussing physics of tunnels with Mayor Vargas (who has a physics background). Hawthorne support for The Boring Co… https://t.co/Doh7qwm8DM,18666,2874,21540,2017-07-21
2557,888535020218056706,Fri Jul 21 23:03:51 +0000 2017,RT @Teslarati: SpaceX skipping Red Dragon for “vastly bigger ships” on Mars https://t.co/8Re70QsYSI https://t.co/fyJNU4gmpt,0,546,546,2017-07-21
2558,888506295157960704,Fri Jul 21 21:09:43 +0000 2017,@kglickstein @LeeannTweeden Kinda have to :),240,14,254,2017-07-21
2559,888506080837468160,Fri Jul 21 21:08:51 +0000 2017,@DrChrisVieira LA-SF-Reno/Sparks would be great. Tesla logistics costs for Sparks-Fremont (batteries &amp; motors) and… https://t.co/LkeEElTDiX,390,37,427,2017-07-21
2560,888365784153694208,Fri Jul 21 11:51:22 +0000 2017,"@libbycwatson Verbal approval was at Federal level. Still a lot of work before formal, written approval, but this o… https://t.co/a9PhUwNkO0",596,82,678,2017-07-21
2561,888230081289695232,Fri Jul 21 02:52:08 +0000 2017,@JosephThuney Adding Boston and Providence would be the natural extension of the line,671,94,765,2017-07-21
2562,888141008252407808,Thu Jul 20 20:58:11 +0000 2017,"@mariom An underground Hyperloop would mean no disruption above ground and be way faster, so I think it is he right way to go",766,95,861,2017-07-20
2563,888137602108448771,Thu Jul 20 20:44:39 +0000 2017,@ejohnson99 City of Chicago already approached us about doing a high speed tunnel from O'Hare to downtown. They've been great.,2787,296,3083,2017-07-20
2564,888136631672340480,Thu Jul 20 20:40:48 +0000 2017,"If you want this to happen fast, please let your local &amp; federal elected representatives know. Makes a big difference if they hear from you.",20069,3263,23332,2017-07-20
2565,888077452265771008,Thu Jul 20 16:45:38 +0000 2017,"Still a lot of work needed to receive formal approval, but am optimistic that will occur rapidly",13803,1374,15177,2017-07-20
2566,888059982586839041,Thu Jul 20 15:36:13 +0000 2017,@curiousworlds For sure. First set of tunnels are to alleviate greater LA urban congestion. Will start NY-DC in par… https://t.co/N3iENcAtdh,3562,670,4232,2017-07-20
2567,888058745153912837,Thu Jul 20 15:31:18 +0000 2017,@DaveLeeBBC Support would be much appreciated!,3248,183,3431,2017-07-20
2568,888053729919877120,Thu Jul 20 15:11:23 +0000 2017,"City center to city center in each case, with up to a dozen or more entry/exit elevators in each city",20431,3357,23788,2017-07-20
2569,888053175155949572,Thu Jul 20 15:09:10 +0000 2017,Just received verbal govt approval for The Boring Company to build an underground NY-Phil-Balt-DC Hyperloop. NY-DC in 29 mins.,196655,70402,267057,2017-07-20
2570,887782904360816640,Wed Jul 19 21:15:13 +0000 2017,"@jeff_foust Plan is to do powered landings on Mars for sure, but with a vastly bigger ship",4079,534,4613,2017-07-19
2571,887394908264210432,Tue Jul 18 19:33:27 +0000 2017,RT @TheOnion: New MIT Study Suggests Sonic The Hedgehog Might Be Living In Computer Simulation https://t.co/kIlw13UWM0 https://t.co/sobOGxk…,0,2832,2832,2017-07-18
2572,887394576427700224,Tue Jul 18 19:32:08 +0000 2017,RT @NASA: We want YOU to experience the next @SpaceX cargo launch to @Space_Station! Apply to attend #NASASocial event in Aug: https://t.co…,0,1017,1017,2017-07-18
2573,887052999079600128,Mon Jul 17 20:54:50 +0000 2017,RT @TeslaMotors: Tesla welcomes Linda Johnson Rice and James Murdoch as new independent directors to its board https://t.co/PPMbMflILh,0,689,689,2017-07-17
2574,887039239837241344,Mon Jul 17 20:00:09 +0000 2017,@DellyBeck y,255,18,273,2017-07-17
2575,887038247376834560,Mon Jul 17 19:56:13 +0000 2017,"@aylaberan True. Need to explain full story of Tesla. So much nonsense out there, amplified by propaganda from some… https://t.co/PhqgEuNvyQ",418,48,466,2017-07-17
2576,887035171542753281,Mon Jul 17 19:43:59 +0000 2017,@FredericLambert @ka_choo_choo @ElectrekCo Not attacking Electrek. Just making sure people don't have the wrong impression.,322,19,341,2017-07-17
2577,887029378290298880,Mon Jul 17 19:20:58 +0000 2017,@ElectrekCo Not true. Email from customer. https://t.co/4P3QO7EMLW,6428,851,7279,2017-07-17
2578,887027300042104832,Mon Jul 17 19:12:43 +0000 2017,"I should clarify: Tesla stock is obviously high based on past &amp; present, but low if you believe in Tesla's future.… https://t.co/XzG3z7jo0A",23040,4590,27630,2017-07-17
2579,887012021232820225,Mon Jul 17 18:12:00 +0000 2017,"@yeematt @noooooomad Yeah, otherwise hard to find them",204,6,210,2017-07-17
2580,886456382018408448,Sun Jul 16 05:24:05 +0000 2017,"RT @tanyaofmars: 20. Because this can never be shared enough: @MarsCuriosity took images as it was landing &amp; the result was AWESOME:

https…",0,1608,1608,2017-07-16
2581,886329304036126720,Sat Jul 15 20:59:07 +0000 2017,@ZsoltBarta42 y,270,16,286,2017-07-15
2582,886019702736039936,Sat Jul 15 00:28:53 +0000 2017,"@fcingolani It is true, so fine by me",1342,40,1382,2017-07-15
2583,886011377357160452,Fri Jul 14 23:55:48 +0000 2017,"@monster_bo1 Small thing (very small), but I made it this way for those who care and understand. Source and appearance are the same.",4727,354,5081,2017-07-14
2584,885921115435974657,Fri Jul 14 17:57:08 +0000 2017,It's what you don't say,35952,14073,50025,2017-07-14
2585,885916571549351941,Fri Jul 14 17:39:04 +0000 2017,@GoDaddy I do have one question. What does GoDaddy mean?,1308,298,1606,2017-07-14
2586,885888274119540737,Fri Jul 14 15:46:38 +0000 2017,@fcingolani Good point,1254,27,1281,2017-07-14
2587,885886076631433216,Fri Jul 14 15:37:54 +0000 2017,Fixed. Now it's good.,8223,631,8854,2017-07-14
2588,885884897381896193,Fri Jul 14 15:33:13 +0000 2017,@franticnews Yes,955,55,1010,2017-07-14
2589,885780183088680961,Fri Jul 14 08:37:07 +0000 2017,@BenedictEvans @stevesi Stay tuned,751,28,779,2017-07-14
2590,885779237038424064,Fri Jul 14 08:33:21 +0000 2017,@stevesi I told you it was verbose. Better tomorrow :),1419,30,1449,2017-07-14
2591,885776126148083712,Fri Jul 14 08:21:00 +0000 2017,"Excited to announce the launch of https://t.co/J6TuRWIQAA! It's a little verbose right now, but that will be fixed tomorrow.",27001,5751,32752,2017-07-14
2592,885748008410730496,Fri Jul 14 06:29:16 +0000 2017,@echo_rm @Kiwi_Manu Just checked and yes,205,8,213,2017-07-14
2593,885742017006845952,Fri Jul 14 06:05:27 +0000 2017,"@AuerSusan @valleyhack True. Also, Ariane primary bay can deliver slightly heavier satellites than Falcon 9. Falcon Heavy is needed ...",220,17,237,2017-07-14
2594,885738536292327424,Fri Jul 14 05:51:37 +0000 2017,@Oskaiper @valleyhack Commercially procured launches means launches that were openly competed. SpaceX is not allowe… https://t.co/7mky7xhJWV,193,15,208,2017-07-14
2595,885661618834624512,Fri Jul 14 00:45:59 +0000 2017,US Senate hearing on advancing the exploration and settlement of space https://t.co/z2lkDUdXKU,5126,912,6038,2017-07-14
2596,885636192514985984,Thu Jul 13 23:04:57 +0000 2017,"@huntster1701 @m_ac We do that too, but for free",1554,90,1644,2017-07-13
2597,885635944841265152,Thu Jul 13 23:03:58 +0000 2017,@alec_ace11 Hopefully,674,16,690,2017-07-13
2598,885635670315642881,Thu Jul 13 23:02:52 +0000 2017,"Other orgs shd also develop reusable orbital rockets. If an airplane co had reusable airplanes, buying single use a… https://t.co/KqalU0DmPx",11269,2494,13763,2017-07-13
2599,885631620723613696,Thu Jul 13 22:46:47 +0000 2017,@Kiwi_Manu That doesn't sound right,1098,31,1129,2017-07-13
2600,885631423306006528,Thu Jul 13 22:46:00 +0000 2017,"Worth noting that Boeing/Lockheed (""Other US"" on chart) get a billion dollar annual subsidy even if they launch not… https://t.co/5MSaR0GwcR",19400,4818,24218,2017-07-13
2601,885626334503882752,Thu Jul 13 22:25:46 +0000 2017,@VicforM3 Latest S and X tires have internal acoustic foam,324,25,349,2017-07-13
2602,885265133944979456,Wed Jul 12 22:30:30 +0000 2017,Going over the small nuances of Model 3 production. Very important that nothing sounds tinny. https://t.co/q3Aj3Yq8J8,8926,962,9888,2017-07-12
2603,884923882938933249,Tue Jul 11 23:54:29 +0000 2017,@hohocho Cool!,386,10,396,2017-07-11
2604,884915404241477632,Tue Jul 11 23:20:47 +0000 2017,"@TeslaMotors The very near future, not, like, the far away future",10610,935,11545,2017-07-11
2605,884914920130723840,Tue Jul 11 23:18:52 +0000 2017,"You can now drive anywhere in the US (except N Alaska), most of Europe, China &amp; Japan using the Tesla Supercharger… https://t.co/aOJf9YruSE",22275,4297,26572,2017-07-11
2606,884833404595740672,Tue Jul 11 17:54:57 +0000 2017,@AlexHPforQVC @Stevetdent Of course!,220,6,226,2017-07-11
2607,884829255112118272,Tue Jul 11 17:38:28 +0000 2017,"@gregbettinelli @Bill_Gross On University Ave, above the old bakery",476,9,485,2017-07-11
2608,884824155895377920,Tue Jul 11 17:18:12 +0000 2017,"@Stevetdent One of my sons is named Xavier, after Professor X!",3782,268,4050,2017-07-11
2609,884700156485971968,Tue Jul 11 09:05:28 +0000 2017,@jondaily83 That's probably the best use,505,4,509,2017-07-11
2610,884666073978556416,Tue Jul 11 06:50:02 +0000 2017,@jeremys Cool 😎,518,16,534,2017-07-11
2611,884664723429498880,Tue Jul 11 06:44:40 +0000 2017,@VoltzCoreAudio @DJSnM Maybe the upcoming IAC in Adelaide,553,41,594,2017-07-11
2612,884654051861843968,Tue Jul 11 06:02:16 +0000 2017,"@DJSnM It was a tough negotiation, but they seemed like good guys. I hope they kept the stock. Would be worth a lot today.",653,18,671,2017-07-11
2613,884653079936720897,Tue Jul 11 05:58:24 +0000 2017,"@soswow @marthajross @mercnews That pizza looked about as appetizing as drywall. If anything, they were doing peopl… https://t.co/qm5JTnYZLj",375,22,397,2017-07-11
2614,884645345828904960,Tue Jul 11 05:27:41 +0000 2017,"@marthajross @mercnews Wasn't wearing a suit, am def not part of a ""posse"" &amp; didn't even know Leo/Orlando were goin… https://t.co/d2krK9xsNm",3341,122,3463,2017-07-11
2615,884580654117076992,Tue Jul 11 01:10:37 +0000 2017,"Thanks PayPal for allowing me to buy back https://t.co/bOUOejO16Y! No plans right now, but it has great sentimental value to me.",31015,3582,34597,2017-07-11
2616,883910005644251141,Sun Jul 09 04:45:42 +0000 2017,https://t.co/is6Hthjjoj,94146,20441,114587,2017-07-09
2617,883900030163324930,Sun Jul 09 04:06:03 +0000 2017,First Production Model 3 https://t.co/TCa2NSUNI3,150189,41323,191512,2017-07-09
2618,883857208181751808,Sun Jul 09 01:15:54 +0000 2017,"@yoda It's who is first to pay full price for the car. Hard rule. I have first Roadster and X, but not first S.",1668,90,1758,2017-07-09
2619,883848060119527424,Sun Jul 09 00:39:33 +0000 2017,"@bdsams Ira Ehrenpreis had rights to 1st car as he was 1st to place a full deposit, but gave those rights to me as… https://t.co/gIkb0p8Jms",2777,207,2984,2017-07-09
2620,883840893253451780,Sun Jul 09 00:11:04 +0000 2017,Production unit 1 of Model 3 is now built and going through final checkout. Pics soon.,59471,10222,69693,2017-07-09
2621,883636811544764418,Sat Jul 08 10:40:07 +0000 2017,RT @mcannonbrookes: ⚡️! This is a massive win for Australia. No more coal in Parliament. Worlds biggest 🔋! World leading energy effort. htt…,0,896,896,2017-07-08
2622,883633822390026240,Sat Jul 08 10:28:15 +0000 2017,@VoyTechnology Never heard of them,1630,69,1699,2017-07-08
2623,883632780264914945,Sat Jul 08 10:24:06 +0000 2017,"Stop biting my finger dammit 
https://t.co/Xh4XHzCWcv
https://t.co/IAlG7khUP4",8663,1112,9775,2017-07-08
2624,883220612260519936,Fri Jul 07 07:06:18 +0000 2017,RT @BBCWorld: Tesla to build 'biggest battery' https://t.co/Y5L8WTwLdy,0,1807,1807,2017-07-07
2625,883197149122633728,Fri Jul 07 05:33:04 +0000 2017,RT @HuffPostAU: .@elonmusk's @TeslaMotors is helping South Australia build the world's largest lithium-ion battery https://t.co/UgJZy5pD78,0,1453,1453,2017-07-07
2626,883169447472750592,Fri Jul 07 03:42:59 +0000 2017,This will be the highest power battery system in the world by a factor of 3. Australia rocks!! https://t.co/c1DD7xtC90,34039,9299,43338,2017-07-07
2627,882939670895755264,Thu Jul 06 12:29:56 +0000 2017,"@newscientist The world's population is accelerating towards collapse, but few seem to notice or care",10628,3054,13682,2017-07-06
2628,882761133177790464,Thu Jul 06 00:40:29 +0000 2017,@SpaceX @INTELSAT Thanks @INTELSAT! Really proud of the rocket and SpaceX team today. Min apogee requirement was 28… https://t.co/EvAel0OajT,6771,795,7566,2017-07-06
2629,882727063525797889,Wed Jul 05 22:25:06 +0000 2017,SpaceX team reviewed all systems again late last night. Done our best to ensure all is good. https://t.co/R3YrF6PEt4,9037,1081,10118,2017-07-05
2630,882117255407980545,Tue Jul 04 06:01:57 +0000 2017,@SpaceX We're going to spend the 4th doing a full review of rocket &amp; pad systems. Launch no earlier than 5th/6th. O… https://t.co/TH4zadUFb1,8728,1078,9806,2017-07-04
2631,882007043472728064,Mon Jul 03 22:44:00 +0000 2017,Wanted to say thanks to all that own or ordered a Tesla. It matters to us that you took a risk on a new car company. We won't forget.,74447,8400,82847,2017-07-03
2632,881757617416056832,Mon Jul 03 06:12:52 +0000 2017,"Looks like we can reach 20,000 Model 3 cars per month in Dec",25955,4334,30289,2017-07-03
2633,881755501905588226,Mon Jul 03 06:04:28 +0000 2017,"Handover party for first 30 customer Model 3's on the 28th! Production grows exponentially, so Aug should be 100 cars and Sept above 1500.",20108,3690,23798,2017-07-03
2634,881751358407299072,Mon Jul 03 05:48:00 +0000 2017,Model 3 passed all regulatory requirements for production two weeks ahead of schedule. Expecting to complete SN1 on Friday,52435,9960,62395,2017-07-03
2635,881598365242318848,Sun Jul 02 19:40:04 +0000 2017,@cristian_miuta @TeslaMotors Norway is awesome,2352,166,2518,2017-07-02
2636,881591960900820992,Sun Jul 02 19:14:37 +0000 2017,"@30akshay Actually, China manufacturing quality is excellent. Among other things, that's where iPhones, many Androi… https://t.co/L1y9wpZMEF",2064,218,2282,2017-07-02
2637,881573728416481280,Sun Jul 02 18:02:10 +0000 2017,Another SpaceX launch today if weather is good https://t.co/UdUYn8Kf0C,14092,2119,16211,2017-07-02
2638,881573366565527553,Sun Jul 02 18:00:44 +0000 2017,@TimDehoucke Coming later today,1071,117,1188,2017-07-02
2639,881572917586178048,Sun Jul 02 17:58:57 +0000 2017,Sorry to hear about China launch failure today. I know how painful that is to the people who designed &amp; built it. https://t.co/iOkj6egF3O,13064,2086,15150,2017-07-02
2640,881571150630756352,Sun Jul 02 17:51:55 +0000 2017,@JaneidyEve @arstechnica @TeslaMotors @SpaceX Suggestions welcome!,488,40,528,2017-07-02
2641,880818231417511937,Fri Jun 30 16:00:05 +0000 2017,@tehwrx @martinengwicht @ThePhoenixFlare I think Einstein said that,452,17,469,2017-06-30
2642,880817971278434304,Fri Jun 30 15:59:03 +0000 2017,@tehwrx @martinengwicht @ThePhoenixFlare Or does the Earth move up?,440,12,452,2017-06-30
2643,880682010133630976,Fri Jun 30 06:58:48 +0000 2017,@ThePhoenixFlare This is a really great floor,879,48,927,2017-06-30
2644,880679414274691073,Fri Jun 30 06:48:29 +0000 2017,Just installed steel skeleton of the car/pod elevator. Should be operating next week. https://t.co/DIZW7zuWaA,17679,2595,20274,2017-06-30
2645,880675074231107584,Fri Jun 30 06:31:14 +0000 2017,Across the road and below the ground https://t.co/E2DG8EzaXg,12220,1607,13827,2017-06-30
2646,880673804028194817,Fri Jun 30 06:26:11 +0000 2017,Perspective https://t.co/4DW9csSmtl,20217,2069,22286,2017-06-30
2647,880666691587461120,Fri Jun 30 05:57:55 +0000 2017,"@satalino15 Nothing to be done, but wait. It's all right here: https://t.co/BIcT4avkJ1",408,19,427,2017-06-30
2648,880665053162348546,Fri Jun 30 05:51:25 +0000 2017,@DouglasABailey News on Sunday,2055,289,2344,2017-06-30
2649,880489685125967872,Thu Jun 29 18:14:34 +0000 2017,Because it's off the wall,8448,904,9352,2017-06-29
2650,880488338964201472,Thu Jun 29 18:09:13 +0000 2017,@Trucker_Ty_ @SavvyTroll @GeorgeTakei Maybe it is time for the man cape to return,321,15,336,2017-06-29
2651,880326099342827520,Thu Jun 29 07:24:32 +0000 2017,@ixmeteorite @newscientist Didn't read it. Might now though.,259,12,271,2017-06-29
2652,880321880216846336,Thu Jun 29 07:07:46 +0000 2017,@newscientist Exactly,652,45,697,2017-06-29
2653,880317052661121025,Thu Jun 29 06:48:35 +0000 2017,@MxPR Me too,1096,27,1123,2017-06-29
2654,880301259093270530,Thu Jun 29 05:45:50 +0000 2017,"@SimplyDonya Yes, but arguably that's worse",4606,267,4873,2017-06-29
2655,880298154440114176,Thu Jun 29 05:33:29 +0000 2017,And I don't care who knows it. Our love will never die.,16462,3036,19498,2017-06-29
2656,880255239881768961,Thu Jun 29 02:42:58 +0000 2017,Just try one. It's way better than you think.,9572,1472,11044,2017-06-29
2657,880252648728940544,Thu Jun 29 02:32:40 +0000 2017,@itsBorked A floor that moves,3701,436,4137,2017-06-29
2658,880252556357672960,Thu Jun 29 02:32:18 +0000 2017,@SyrenBoaz A ceiling is simply a floor from below,4629,1107,5736,2017-06-29
2659,880240745319325697,Thu Jun 29 01:45:22 +0000 2017,Not as much as tunnels though,13012,2085,15097,2017-06-29
2660,880240682836705282,Thu Jun 29 01:45:07 +0000 2017,They are so underappreciated,12532,2461,14993,2017-06-29
2661,880240283081883648,Thu Jun 29 01:43:32 +0000 2017,They will never let you down,23397,5672,29069,2017-06-29
2662,880240049677357057,Thu Jun 29 01:42:36 +0000 2017,I love floors,57560,20978,78538,2017-06-29
2663,880208110719123456,Wed Jun 28 23:35:41 +0000 2017,@SandyMazza Gary (the snail) is a speed demon. Long way to go before we beat him/her.,931,80,1011,2017-06-28
2664,880201693496987648,Wed Jun 28 23:10:11 +0000 2017,"@TEDTalks Thanks, but I am",7959,677,8636,2017-06-28
2665,880201464370442240,Wed Jun 28 23:09:17 +0000 2017,No longer waiting for Godot. It has begun boring and just completed the first segment of tunnel in LA.,19044,2833,21877,2017-06-28
2666,879412656016285696,Mon Jun 26 18:54:50 +0000 2017,"Good summary of rocket landing history. There were two successful water landings much earlier, but they didn't surv… https://t.co/CNxoM9Oj9R",17902,5412,23314,2017-06-26
2667,879391845347766272,Mon Jun 26 17:32:08 +0000 2017,"@Viss Several tons of force on each fin at high angles of attack &amp; peak heating is the cube of speed, so a Mach 8 r… https://t.co/YcqjWZpH3f",403,37,440,2017-06-26
2668,879104704583581696,Sun Jun 25 22:31:09 +0000 2017,@migueldelagza They should on high velocity missions to Geostationary Transfer Orbit,472,18,490,2017-06-25
2669,879092174390001665,Sun Jun 25 21:41:21 +0000 2017,Sped up version of today's rocket landing on the Droneship Just Read the Instructions (guess it… https://t.co/0wFgXMgeqZ,11228,3199,14427,2017-06-25
2670,879086784969191424,Sun Jun 25 21:19:56 +0000 2017,@nullpointr More aero effectiveness to create steep spires on windward side at the grid fin intersections,409,19,428,2017-06-25
2671,879086372832722944,Sun Jun 25 21:18:18 +0000 2017,"@amirmasoudabdol Down the road, they will not even be repainted between launches. Aiming to be able to relaunch sam… https://t.co/Ze7aQlwf84",1262,183,1445,2017-06-25
2672,879085297526464513,Sun Jun 25 21:14:02 +0000 2017,@BenjaminCoop3 Getting closer to fairing recovery and reuse. Had some problems with the steerable parachute. Should… https://t.co/6YmUejl5Q4,843,95,938,2017-06-25
2673,879080848359686144,Sun Jun 25 20:56:21 +0000 2017,New titanium grid fins worked even better than expected. Should be capable of an indefinite number of flights with no service.,24370,2971,27341,2017-06-25
2674,879067621466849280,Sun Jun 25 20:03:47 +0000 2017,@mjmdavis Still humans,452,17,469,2017-06-25
2675,879067405573435392,Sun Jun 25 20:02:56 +0000 2017,@TheCocoaNaut Significantly improves control force,424,9,433,2017-06-25
2676,879067060558417921,Sun Jun 25 20:01:34 +0000 2017,Launch at 1:25 delivering 10 satellites for Iridium. Droneship repositioned due to extreme weather. Will be tight. https://t.co/6ZcSG29B74,6453,1156,7609,2017-06-25
2677,879065552060260352,Sun Jun 25 19:55:34 +0000 2017,"Closeup of the titanium grid fins. Not painted, as they glow red hot during a fast reentry. https://t.co/Ltrq1Prg2m",17635,2817,20452,2017-06-25
2678,878839825473822720,Sun Jun 25 04:58:37 +0000 2017,"@dnathe4th @DJSnM We used to have a (lame) open loop hydraulic system, but that was upgraded to closed about 2 years ago",547,23,570,2017-06-25
2679,878829325742518273,Sun Jun 25 04:16:53 +0000 2017,"@CrappyUsername Not only that, it has all the wifis and 3G is coming soon",695,42,737,2017-06-25
2680,878828849722671104,Sun Jun 25 04:15:00 +0000 2017,@EcoHeliGuy Rocket was suddenly slammed sideways right before landing. Heavy gust or something malfunctioned onboard. Reviewing telemetry.,544,43,587,2017-06-25
2681,878824485280817153,Sun Jun 25 03:57:39 +0000 2017,"@zerosixbravo @john_gilleran True, but that's a minor factor for rockets",292,6,298,2017-06-25
2682,878824283178287105,Sun Jun 25 03:56:51 +0000 2017,"@ClovenLife No, but shielding got fragged every flight. More control authority is for Falcon Heavy, but also enable… https://t.co/mWpvc3JVXK",393,17,410,2017-06-25
2683,878823434268033025,Sun Jun 25 03:53:29 +0000 2017,"@DJSnM They will, but the hydraulic system is closed loop, so no fluid lost. They do need more power &amp; energy, but… https://t.co/sA14IPO1MQ",755,31,786,2017-06-25
2684,878822240699035649,Sun Jun 25 03:48:44 +0000 2017,"@zerosixbravo Slightly heavier than shielded aluminum, but more control authority and can be reused indefinitely with no touch ups",709,39,748,2017-06-25
2685,878821062326198272,Sun Jun 25 03:44:03 +0000 2017,Flying with larger &amp; significantly upgraded hypersonic grid fins. Single piece cast &amp; cut titanium. Can take reentr… https://t.co/LBeh06LzHY,13357,2240,15597,2017-06-25
2686,878407054083317760,Sat Jun 24 00:18:56 +0000 2017,@sajo Sticking to 100,557,16,573,2017-06-24
2687,878335496413265920,Fri Jun 23 19:34:35 +0000 2017,"@Emerald0013 It's an aluminum honeycomb cartridge, so only a couple of hours to replace",1656,92,1748,2017-06-23
2688,878334920141135872,Fri Jun 23 19:32:18 +0000 2017,"Rocket is extra toasty and hit the deck hard (used almost all of the emergency crush core), but otherwise good",24609,3611,28220,2017-06-23
2689,878328287012966400,Fri Jun 23 19:05:56 +0000 2017,RT @SpaceX: Webcast of Falcon 9 launch is now live → https://t.co/gtC39uBC7z,0,993,993,2017-06-23
2690,878313692986621953,Fri Jun 23 18:07:57 +0000 2017,Falcon 9 will experience its highest ever reentry force and heat in today's launch. Good chance rocket booster doesn't make it back.,15634,2420,18054,2017-06-23
2691,878300364008640512,Fri Jun 23 17:14:59 +0000 2017,"@shanghai_artist Technically, Ironyman",422,27,449,2017-06-23
2692,878296162184290304,Fri Jun 23 16:58:17 +0000 2017,@ExploreSpaceKSC Thanks! Looks cool.,528,13,541,2017-06-23
2693,878276214586195968,Fri Jun 23 15:39:01 +0000 2017,"RT @SpaceX: Falcon 9 and BulgariaSat-1 vertical on Pad 39A. Today’s two-hour launch window opens at 2:10 p.m. EDT, 18:10 UTC. https://t.co/…",0,1583,1583,2017-06-23
2694,878044200960380928,Fri Jun 23 00:17:05 +0000 2017,"@WaywardPlane Damn, I forgot bacon",2192,151,2343,2017-06-23
2695,878041692292526080,Fri Jun 23 00:07:07 +0000 2017,"RT @justAfanDavid: @elonmusk like the quote says:

“We are our choices.” 
― Jean-Paul Sartre",0,593,593,2017-06-23
2696,878040258541043713,Fri Jun 23 00:01:25 +0000 2017,"In life, there are no easy choices …",10076,2146,12222,2017-06-23
2697,878037431789826049,Thu Jun 22 23:50:11 +0000 2017,Do want irony on social media?,6859,1909,8768,2017-06-22
2698,877930155540336640,Thu Jun 22 16:43:54 +0000 2017,Must remember that irony and social media are not friends. Keep forgetting. Dammit.,25733,4654,30387,2017-06-22
2699,877928338358099969,Thu Jun 22 16:36:41 +0000 2017,@partialobs @SpaceX Radiation,539,27,566,2017-06-22
2700,877740365217882113,Thu Jun 22 04:09:45 +0000 2017,@DPazdan Groan,673,25,698,2017-06-22
2701,877740102918721536,Thu Jun 22 04:08:42 +0000 2017,"@hayskeys7 But RWD with electric is really good in snow (assuming all weather or winter tires), as traction control is far more precise",533,36,569,2017-06-22
2702,877739704593993728,Thu Jun 22 04:07:07 +0000 2017,@hayskeys7 Will extend,491,16,507,2017-06-22
2703,877469994593820674,Wed Jun 21 10:15:23 +0000 2017,Over 1000 km should be possible in a 100D with the right tires https://t.co/8czN3dVZE4,20047,4553,24600,2017-06-21
2704,877449345078968321,Wed Jun 21 08:53:20 +0000 2017,RT @karpathy: Excited to join Tesla as the Director of AI! https://t.co/5AdhaF40kM,0,1959,1959,2017-06-21
2705,877341165808361472,Wed Jun 21 01:43:28 +0000 2017,@Painkiller606 Will be full regen cooled all the way out to the 3 meter (10 ft) nozzle diameter. Heat flux is nuts… https://t.co/F9jLd22g6K,217,22,239,2017-06-21
2706,877339887732539392,Wed Jun 21 01:38:24 +0000 2017,@dadxseven No plans to change 100 kWh pack tech. You'll never worry about running out of range. Model 3 pack is abo… https://t.co/Xa0mcW2JJi,236,14,250,2017-06-21
2707,877292613816078336,Tue Jun 20 22:30:33 +0000 2017,"RT @SpaceX: Static fire test of Falcon 9 at Vandenberg AFB complete—launch of 10 @IridiumComm NEXT satellites slated for Sunday, June 25.",0,728,728,2017-06-20
2708,877210236502786048,Tue Jun 20 17:03:12 +0000 2017,No need to rely on scientists for global warming -- just use a thermometer https://t.co/0PbtAL8uRK,15361,5644,21005,2017-06-20
2709,877039014334701568,Tue Jun 20 05:42:50 +0000 2017,@sulka @KarinCAtrades Cool,201,8,209,2017-06-20
2710,877032118794108928,Tue Jun 20 05:15:26 +0000 2017,"@sulka That's because the accurate articles are boringly obvious, so they get no press attention",271,29,300,2017-06-20
2711,877031628861657088,Tue Jun 20 05:13:29 +0000 2017,"@sulka First approximation of CO2 is production cost, factoring in energy source, so Model 3 obv less CO2 to produc… https://t.co/zWShDpd7L6",609,57,666,2017-06-20
2712,877029802758201344,Tue Jun 20 05:06:14 +0000 2017,@sulka Calling this cueless would be generous. Much less energy required for lithium-ion batteries &amp; Gigafactory is… https://t.co/2UEsh93JIE,1173,120,1293,2017-06-20
2713,876829309695967232,Mon Jun 19 15:49:32 +0000 2017,@shashwatbakhshi No plans to change cell form factor for X and S,169,17,186,2017-06-19
2714,876586808255029248,Sun Jun 18 23:45:55 +0000 2017,"@verge This is crazy, but Max Smart mentions Chaos towards the end. Coincidence?",213,21,234,2017-06-18
2715,876575063058677760,Sun Jun 18 22:59:15 +0000 2017,@quiggles There's a plot!?,452,21,473,2017-06-18
2716,876571952512507908,Sun Jun 18 22:46:54 +0000 2017,@RobTheIc0n ujelly?,416,25,441,2017-06-18
2717,876570254184390656,Sun Jun 18 22:40:09 +0000 2017,"@DJ_Mr_Cool My real phone is an HTC Droid, which I ordered after seeing this ad https://t.co/WLR9cJGXP1",1732,363,2095,2017-06-18
2718,876567497062850560,Sun Jun 18 22:29:11 +0000 2017,"@verge Nothing beats the shoe phone that is also a real shoe 
https://t.co/cLecmtHrdN",630,60,690,2017-06-18
2719,876565296487649280,Sun Jun 18 22:20:27 +0000 2017,@YS But then I get paid less,1779,82,1861,2017-06-18
2720,876537450956337152,Sun Jun 18 20:29:48 +0000 2017,"@theseoldcars Backup valve shows no sign of leaking, but yeah",206,5,211,2017-06-18
2721,876536951418925057,Sun Jun 18 20:27:49 +0000 2017,If schedule holds there will be two Falcon 9 launches within 48 hours (Cape &amp; Vandenberg) this weekend https://t.co/GbleRPm6iZ,9578,1683,11261,2017-06-18
2722,876536406230712320,Sun Jun 18 20:25:39 +0000 2017,"Postponing launch to replace fairing pneumatic valve. It is dual redundant, but not worth taking a chance. https://t.co/vnfxmeer7h",3968,481,4449,2017-06-18
2723,876517194997178368,Sun Jun 18 19:09:18 +0000 2017,"Promising conversations with @MayorOfLA regarding tunnel network that would carry cars, bikes &amp; pedestrians. Permit… https://t.co/hlm62sTtZA",5227,932,6159,2017-06-18
2724,876494001607589888,Sun Jun 18 17:37:09 +0000 2017,https://t.co/tj4FrDw34z,3861,532,4393,2017-06-18
2725,876492802648965120,Sun Jun 18 17:32:23 +0000 2017,It's time they knew … https://t.co/wt7XfXqTM6,33815,4464,38279,2017-06-18
2726,876160515055038464,Sat Jun 17 19:31:59 +0000 2017,"Tesla service rescues a kitten stuck in the bumper 
https://t.co/qZW7QjuceQ
https://t.co/3jyJseVodm",10912,2278,13190,2017-06-17
2727,875913778423939072,Sat Jun 17 03:11:33 +0000 2017,@zlsadesign So soon you won't believe it,1079,140,1219,2017-06-17
2728,875913504451985411,Sat Jun 17 03:10:27 +0000 2017,Colonizing Mars (thanks Prof Hubbard for creating this from my talk). Major changes to the plan coming soon. https://t.co/s59qMHUj5O,10445,2840,13285,2017-06-17
2729,875849793204928512,Fri Jun 16 22:57:17 +0000 2017,"Hawthorne, California https://t.co/d5qRlN0XQ7",25764,6437,32201,2017-06-16
2730,875839151056310272,Fri Jun 16 22:15:00 +0000 2017,Flying through the Falcon Factory https://t.co/kIuqfD3MLQ,5968,1194,7162,2017-06-16
2731,875770056323420160,Fri Jun 16 17:40:27 +0000 2017,"Mars V2 plan coming soon, which I think addresses the most fundamental flaw in V1: how to pay for development &amp; ope… https://t.co/BLeWrzsRLQ",17621,5356,22977,2017-06-16
2732,875510004635246592,Fri Jun 16 00:27:05 +0000 2017,@dane @bonnienorman Radar-only braking on HW1 is getting better with every release. We're hoping to do the demo whe… https://t.co/H3zTx8P4eG,387,30,417,2017-06-16
2733,875509067011153924,Fri Jun 16 00:23:22 +0000 2017,"$300M cost diff between SpaceX and Boeing/Lockheed exceeds avg value of satellite, so flying with SpaceX means sate… https://t.co/JmSlam4s6A",23752,6089,29841,2017-06-16
2734,875070931537981441,Wed Jun 14 19:22:22 +0000 2017,@jasveer10 In discussions with the government of India requesting temporary relief on import penalties/restrictions… https://t.co/pla865ZLne,3771,1115,4886,2017-06-14
2735,875051512422178816,Wed Jun 14 18:05:12 +0000 2017,"RT @cnntech: The Tesla Model X is the safest SUV ever tested, according to The National Highway Traffic Safety Administration. https://t.co…",0,3047,3047,2017-06-14
2736,875051480407052288,Wed Jun 14 18:05:05 +0000 2017,RT @jovanik21: @TheRealPortela @elonmusk @cnntech Best customer service I've ever received!!!,0,75,75,2017-06-14
2737,874649718659325952,Tue Jun 13 15:28:37 +0000 2017,US govt testing by @NHTSAgov finds Model X to be the safest SUV in history by significant margin https://t.co/zAdb5FQPEI,21116,4865,25981,2017-06-13
2738,874649035855978496,Tue Jun 13 15:25:54 +0000 2017,RT @OpenAI: Using human feedback rather than code to specify a task: https://t.co/3YzBUM9flo Safety collaboration with @DeepMindAI https://…,0,714,714,2017-06-13
2739,874547695767007232,Tue Jun 13 08:43:13 +0000 2017,RT @ElectrekCo: Watch the first Tesla Model X crash tests - 5 stars expected in every category https://t.co/Qp6XfBsBuC https://t.co/defNKGH…,0,629,629,2017-06-13
2740,874539511815954433,Tue Jun 13 08:10:42 +0000 2017,"@samsheffer That would an interesting target. Would, of course, only count if capable of doing so right off the pro… https://t.co/ZbZBwPPLtd",851,73,924,2017-06-13
2741,874506910120034306,Tue Jun 13 06:01:09 +0000 2017,@AaronTheSilver @sama How'd you know?,181,7,188,2017-06-13
2742,874483570869272577,Tue Jun 13 04:28:25 +0000 2017,"@ethank @ElectrekCo @TeslaRoadTrip Linux kernel update was way harder than anticipated. Giant improvement, but mean… https://t.co/onCbEsAWmt",191,15,206,2017-06-13
2743,874029202768510977,Sun Jun 11 22:22:55 +0000 2017,"@ethank @ElectrekCo @TeslaRoadTrip New kernel goes out next weekend, new web browser next month. Radar-only braking… https://t.co/eSvRTzQ4L3",268,20,288,2017-06-11
2744,873984057431949312,Sun Jun 11 19:23:31 +0000 2017,@ElectrekCo @TeslaRoadTrip HW2 Autopilot release should go wide next weekend with additional smoothness improvements to longitudinal control,597,86,683,2017-06-11
2745,873629817895133184,Sat Jun 10 19:55:54 +0000 2017,"@RajveerJolly We are developing the interplanetary rocket and spaceship to allow anyone to travel to the moon, Mars… https://t.co/yQ8NzZJx1Y",6856,1269,8125,2017-06-10
2746,873628555057352705,Sat Jun 10 19:50:53 +0000 2017,@KevinWright80 Thanks! Everything we make on the expensive cars goes into developing more affordable cars.,347,30,377,2017-06-10
2747,873313746172628992,Fri Jun 09 22:59:57 +0000 2017,@StevePrediletto @samabuelsamid @TeslaMotors Thanks for supporting Tesla and the EV mission before anyone had heard of us,324,22,346,2017-06-09
2748,873312073756753920,Fri Jun 09 22:53:18 +0000 2017,@FredericLambert @samabuelsamid @TeslaMotors Heard about it. Our experience doing projects with big car companies w… https://t.co/GHZ3kmHzkh,296,26,322,2017-06-09
2749,873310575073255425,Fri Jun 09 22:47:21 +0000 2017,"@samabuelsamid @TeslaMotors I've written two forward-looking master plans, but haven't told the Tesla history of ho… https://t.co/qxQdi3VgWl",369,21,390,2017-06-09
2750,873308039733952512,Fri Jun 09 22:37:16 +0000 2017,@samabuelsamid @TeslaMotors Mostly right. The feasibility study Martin commissioned about the Lotus Elise was dead… https://t.co/CET5exTWZ1,352,10,362,2017-06-09
2751,873306583983247360,Fri Jun 09 22:31:29 +0000 2017,"@RITSPEX @ID_AA_Carmack @mmeijeri Slow at first, then very fast. Def not hover.",229,10,239,2017-06-09
2752,873305610971787264,Fri Jun 09 22:27:37 +0000 2017,"@ID_AA_Carmack @mmeijeri The faster, the better. Gravity losses.",414,26,440,2017-06-09
2753,873305406482784256,Fri Jun 09 22:26:48 +0000 2017,@mcwm @chrispaine Damn Stonecutters!,636,34,670,2017-06-09
2754,873301658155061248,Fri Jun 09 22:11:55 +0000 2017,"@EclecticLip Was no ""company"", just a (wrong) biz plan to commercialize ACP's Tzero car. No tech or IP, no employee… https://t.co/PXOi42YS7d",316,24,340,2017-06-09
2755,873299731853615104,Fri Jun 09 22:04:15 +0000 2017,"@__svndee Disruption certainly. Deep AI is the real risk, though, not automation.",193,19,212,2017-06-09
2756,873299488579899392,Fri Jun 09 22:03:17 +0000 2017,RT @businessinsider: We tried @TeslaMotors's 'Summon' feature — where the car comes and picks you up https://t.co/zSJz1IFQiX,0,4518,4518,2017-06-09
2757,873266603349073920,Fri Jun 09 19:52:37 +0000 2017,@rami_syvari @clevergoat @mor10 Exactly,359,21,380,2017-06-09
2758,873248942250573824,Fri Jun 09 18:42:26 +0000 2017,Congrats Robb! https://t.co/4OaB8t0yoq,7947,806,8753,2017-06-09
2759,873211353091014656,Fri Jun 09 16:13:04 +0000 2017,@MarkeR2002 @chrispaine So crazy that people were arrested for trying to keep their cars from being destroyed,641,65,706,2017-06-09
2760,873210566826803201,Fri Jun 09 16:09:57 +0000 2017,@isco__ You may have Heard of the person who put it together,270,27,297,2017-06-09
2761,873210142573043712,Fri Jun 09 16:08:16 +0000 2017,"Worth watching ""Who Killed the Electric Car?"" By @chrispaine. Truth is indeed stranger than fiction … https://t.co/b8rKpp8nvJ",8235,1959,10194,2017-06-09
2762,873202292048015360,Fri Jun 09 15:37:04 +0000 2017,"@Franco_FWG @Zedd If Zedd is kind enough to send me a list, it's on",340,32,372,2017-06-09
2763,873131202663690240,Fri Jun 09 10:54:35 +0000 2017,"@ApexCornerSpeed @BraveRock_ All Superchargers are being converted to solar/battery power. Over time, almost all wi… https://t.co/3KswdLfsbI",2169,423,2592,2017-06-09
2764,873130508984631296,Fri Jun 09 10:51:49 +0000 2017,"@mor10 I love Norway, which is the world leader in EV adoption! Great example for the rest of the world.",1764,225,1989,2017-06-09
2765,873122114307371015,Fri Jun 09 10:18:28 +0000 2017,"@kieranquinn27 Long way to go, but we've convinced most of the auto industry to start EV programs &amp; gave them all o… https://t.co/VPtXNVPFvF",3771,580,4351,2017-06-09
2766,873121068172460035,Fri Jun 09 10:14:19 +0000 2017,"Nothing to do w govt incentives or making money. Thought 90% prob of losing it all (almost did many times), but it was the only chance.",13265,1587,14852,2017-06-09
2767,873119655354695685,Fri Jun 09 10:08:42 +0000 2017,"Since big car companies were killing their EV programs, the only chance was to create an EV company, even tho it was almost certain to fail",11557,1923,13480,2017-06-09
2768,873117697420034048,Fri Jun 09 10:00:55 +0000 2017,"They was done against the will of their owners, who held a candlelight vigil all night to protest the death of their cars",5591,1145,6736,2017-06-09
2769,873116351316938753,Fri Jun 09 09:55:34 +0000 2017,Few people know that we started Tesla when GM forcibly recalled all electric cars from customers in 2003 &amp; then crushed them in a junkyard,45253,14512,59765,2017-06-09
2770,872979293944414208,Fri Jun 09 00:50:57 +0000 2017,@RafaelM81 @EricaBoarman That is true. Ludicrous mode is like having pure joy on tap. Nothing else (legal) will get you that.,321,28,349,2017-06-09
2771,872974600451219456,Fri Jun 09 00:32:18 +0000 2017,@Boltfinger Click the left scroll wheel to pause or mute music,123,4,127,2017-06-09
2772,872935638944800769,Thu Jun 08 21:57:29 +0000 2017,"@cabbey @JeffMcAdams Good point, will add ""cancel nav"" to voice commands",611,19,630,2017-06-08
2773,872935290356113408,Thu Jun 08 21:56:06 +0000 2017,@EricIdle Too awesome,520,16,536,2017-06-08
2774,872919207754711041,Thu Jun 08 20:52:11 +0000 2017,@Belltower @GarthRedshaw @The1ManHerd Must ipso facto half not bee,115,2,117,2017-06-08
2775,872913130120134656,Thu Jun 08 20:28:02 +0000 2017,"@mashabletech First of all, I cracked a long time ago. That's not news. Second, yes, I can see time. How did you know?",1842,172,2014,2017-06-08
2776,872912379406766080,Thu Jun 08 20:25:03 +0000 2017,"@AndrewHaigh Yeah, car should auto play when it gets an exact match, like it does for directions. Will make that change.",533,12,545,2017-06-08
2777,872912059406491648,Thu Jun 08 20:23:47 +0000 2017,@jovanik21 @philwhln Just confirmed the Tesla DJ station works in Canada,133,3,136,2017-06-08
2778,872907817258070016,Thu Jun 08 20:06:56 +0000 2017,@Krishell1985 Cool,145,0,145,2017-06-08
2779,872906757831409664,Thu Jun 08 20:02:43 +0000 2017,"@sakerjacks No, it's not!",333,6,339,2017-06-08
2780,872906681851576321,Thu Jun 08 20:02:25 +0000 2017,@MichaelGladis Yes,276,2,278,2017-06-08
2781,872906594471755776,Thu Jun 08 20:02:04 +0000 2017,@JeffMcAdams Tap cancel on the screen,205,3,208,2017-06-08
2782,872905905041362944,Thu Jun 08 19:59:20 +0000 2017,"Just tap the voice button on the steering wheel and say ""Play Monty Python"" or ""Navigate home"" or anything. Voice commands work pretty well.",7953,770,8723,2017-06-08
2783,872905016176025601,Thu Jun 08 19:55:48 +0000 2017,"@EricaBoarman Just depends on whether you like a sedan or SUV. Sedan goes faster, SUV has more room.",172,2,174,2017-06-08
2784,872903902282137600,Thu Jun 08 19:51:22 +0000 2017,"@jschindeler Yeah, coming back",142,3,145,2017-06-08
2785,872895237022113792,Thu Jun 08 19:16:56 +0000 2017,@symonchester Coming soon!,280,1,281,2017-06-08
2786,872895060404076544,Thu Jun 08 19:16:14 +0000 2017,@castfxman Partly,395,11,406,2017-06-08
2787,872894904174653440,Thu Jun 08 19:15:37 +0000 2017,@The1ManHerd Possibly my favorite skit,257,2,259,2017-06-08
2788,872894508962205696,Thu Jun 08 19:14:03 +0000 2017,@AngBoire Might work in Canada too,225,4,229,2017-06-08
2789,872894290460004352,Thu Jun 08 19:13:11 +0000 2017,@jovanik21 @philwhln I mean also,145,1,146,2017-06-08
2790,872893699511865345,Thu Jun 08 19:10:50 +0000 2017,@markedtek Not yet,124,0,124,2017-06-08
2791,872893668474052608,Thu Jun 08 19:10:42 +0000 2017,@rrosenbl Yeah,120,1,121,2017-06-08
2792,872893604464779264,Thu Jun 08 19:10:27 +0000 2017,"In the US, you can ask your Tesla to play any Monty Python (or other comedy) skit. Doesn't work outside US yet.",18834,3020,21854,2017-06-08
2793,872893125303222273,Thu Jun 08 19:08:33 +0000 2017,"@philwhln It's on the car. Might add it to the Tesla app at some point, so you get it on your phone if you have a Powerwall or Tesla solar.",263,10,273,2017-06-08
2794,872892636276731904,Thu Jun 08 19:06:36 +0000 2017,@DeanDcruz My favorite for sure,187,5,192,2017-06-08
2795,872892467800023040,Thu Jun 08 19:05:56 +0000 2017,Try the new Tesla DJ station on streaming radio,5491,528,6019,2017-06-08
2796,872889583846924288,Thu Jun 08 18:54:28 +0000 2017,@redletterdave The scene where Brian is saved from the Romans by falling off a tower into a spaceship is the best D… https://t.co/V3XSdyTuWS,291,28,319,2017-06-08
2797,872888863504474112,Thu Jun 08 18:51:37 +0000 2017,"@JohnnyZenith All Falcon Heavy cores should be at the Cape in two to three months, so launch should happen a month after that",757,259,1016,2017-06-08
2798,872888316978274304,Thu Jun 08 18:49:26 +0000 2017,@redletterdave Love Monty Python so much,325,18,343,2017-06-08
2799,872888045170597889,Thu Jun 08 18:48:22 +0000 2017,https://t.co/spUaZYaxgB,3972,704,4676,2017-06-08
2800,872869915337805825,Thu Jun 08 17:36:19 +0000 2017,"Just wish they would stop sticking pins in voodoo dolls of me. That hurts, ok?",20261,2146,22407,2017-06-08
2801,872869542376030208,Thu Jun 08 17:34:50 +0000 2017,@johnbiscevic Yeah,143,0,143,2017-06-08
2802,872869348850913280,Thu Jun 08 17:34:04 +0000 2017,@danahull Yeah,168,3,171,2017-06-08
2803,872868505351094272,Thu Jun 08 17:30:43 +0000 2017,These guys want us to die so bad they can taste it,13425,1766,15191,2017-06-08
2804,872862122509647873,Thu Jun 08 17:05:21 +0000 2017,Could be worse https://t.co/CtnkJysquj,13873,2324,16197,2017-06-08
2805,872645445742231553,Thu Jun 08 02:44:21 +0000 2017,@LABJnews We can either give up hope &amp; sit in traffic hell forever or try something new. The odds of success may be… https://t.co/OyUlsFzqWp,556,84,640,2017-06-08
2806,872601868668555264,Wed Jun 07 23:51:12 +0000 2017,@LABJnews The Boring Company is in Hawthorne and has already approved the permit,1683,131,1814,2017-06-07
2807,872535557997449216,Wed Jun 07 19:27:42 +0000 2017,@kimchee_chigae @SpaceX Thanks :) Such an outrageous lawsuit. People sometimes underestimate strength of US judicia… https://t.co/Hxlj5OZrMp,1236,54,1290,2017-06-07
2808,872349845088075776,Wed Jun 07 07:09:45 +0000 2017,@biseshgrg Read https://t.co/TOyVa7PmNk,1076,239,1315,2017-06-07
2809,872349052016394243,Wed Jun 07 07:06:36 +0000 2017,@SaherShodhan Almost. Falcon Heavy was way harder to develop than it seemed at first.,532,36,568,2017-06-07
2810,872339328013393925,Wed Jun 07 06:27:57 +0000 2017,RT @SpaceX: 4K video of Falcon 9 first stage landing after delivering Dragon to orbit for a @Space_Station resupply mission → https://t.co/…,0,2559,2559,2017-06-07
2811,872322588919443460,Wed Jun 07 05:21:26 +0000 2017,"@sama Once you add the vintage record player, it's all good",1262,37,1299,2017-06-07
2812,872321354279866368,Wed Jun 07 05:16:32 +0000 2017,@farhad667 You're welcome!,336,11,347,2017-06-07
2813,872260000491593728,Wed Jun 07 01:12:44 +0000 2017,"A little red wine, vintage record, some Ambien ... and magic!",23169,3833,27002,2017-06-07
2814,872257953373368320,Wed Jun 07 01:04:36 +0000 2017,@avyas0 A 7 step facial treatment every morning. The mistake people make is stopping at 6.,7653,605,8258,2017-06-07
2815,872257388136484864,Wed Jun 07 01:02:21 +0000 2017,"And um ... not trying to brag or anything, but I think I look good for 500",11422,945,12367,2017-06-07
2816,872170047262687232,Tue Jun 06 19:15:18 +0000 2017,@brokesilver Seems that way,224,5,229,2017-06-06
2817,872150434093252608,Tue Jun 06 17:57:21 +0000 2017,@NigelKBaker Of course. What base-number system were you using?,493,13,506,2017-06-06
2818,872150066462511104,Tue Jun 06 17:55:54 +0000 2017,That's why the pic is in black and white. Didn't have color back then.,7350,470,7820,2017-06-06
2819,872149867006533632,Tue Jun 06 17:55:06 +0000 2017,"@PoyntingCEO Yeah, I counted",473,13,486,2017-06-06
2820,872146674327601152,Tue Jun 06 17:42:25 +0000 2017,Tesla shareholder meeting today. Can't believe it's been 1000 years since we went public. https://t.co/jK7WmuxSLv,12668,1367,14035,2017-06-06
2821,872030545722482688,Tue Jun 06 10:00:58 +0000 2017,RT @newscientist: SpaceX is the first private company to send the same vehicle into orbit twice https://t.co/O0fUAhlF0g https://t.co/yFbNVo…,0,2917,2917,2017-06-06
2822,871977447159283712,Tue Jun 06 06:29:58 +0000 2017,"@rolandscahill @TeslaMotors This is a metaphor for transparency. Also, f* underwear.",803,167,970,2017-06-06
2823,871949276951203840,Tue Jun 06 04:38:02 +0000 2017,@mcgd @MitchellGeere Obviously,390,15,405,2017-06-06
2824,871947630372282368,Tue Jun 06 04:31:29 +0000 2017,"SEC disclosures, etc",4889,292,5181,2017-06-06
2825,871946789305196544,Tue Jun 06 04:28:09 +0000 2017,"I'm not *saying* they're related, but … https://t.co/p5d2zkC7e7",31391,6999,38390,2017-06-06
2826,871915360819204097,Tue Jun 06 02:23:16 +0000 2017,Or is it more about the way you use it? https://t.co/VvqgOX3XFJ,28871,6892,35763,2017-06-06
2827,871914003244605440,Tue Jun 06 02:17:52 +0000 2017,@SmileSimplify I hope I'm wrong,472,39,511,2017-06-06
2828,871886151014940672,Tue Jun 06 00:27:11 +0000 2017,"Probably closer to 2030 to 2040 imo. 2060 would be a linear extrapolation, but progress is exponential. https://t.co/e6gyOVcMZG",17184,5553,22737,2017-06-06
2829,871850248716533760,Mon Jun 05 22:04:32 +0000 2017,@RobinWigg Great comedy! They should write for @TheOnion.,1238,62,1300,2017-06-05
2830,871822308016439296,Mon Jun 05 20:13:30 +0000 2017,@HCPG Most likely,498,15,513,2017-06-05
2831,871805583761956865,Mon Jun 05 19:07:03 +0000 2017,"@hellenomwando @MarkBungerLux Also, we will have a very high headcount around each Gigafactory keeping it running.… https://t.co/rDNUo36rB4",211,18,229,2017-06-05
2832,871805266160893952,Mon Jun 05 19:05:47 +0000 2017,@hellenomwando @MarkBungerLux Probably closer to four or five factories. Logistics costs mean you want to be close to the end customer.,266,35,301,2017-06-05
2833,871784739367116800,Mon Jun 05 17:44:13 +0000 2017,@TheStaceyRoy @TeslaMotors California Cabernet,472,26,498,2017-06-05
2834,871783609492844544,Mon Jun 05 17:39:44 +0000 2017,@rolandscahill @TeslaMotors Wearing anything at all is just a conspiracy by the capitalist running dogs of Big Underwear,6776,1891,8667,2017-06-05
2835,871783010055487488,Mon Jun 05 17:37:21 +0000 2017,RT @TeslaMotors: Send us questions today for Elon to answer at our Shareholders Meeting tomorrow,0,740,740,2017-06-05
2836,871774749352800256,Mon Jun 05 17:04:31 +0000 2017,He was great though,4332,188,4520,2017-06-05
2837,871774615562928128,Mon Jun 05 17:03:59 +0000 2017,https://t.co/Uu6DQa3Kx4,3960,527,4487,2017-06-05
2838,871774429419667457,Mon Jun 05 17:03:15 +0000 2017,Was just at the DMV &amp; dude had the actual sloth from Zootopia on his desk https://t.co/uxPMFX64ba,13409,1751,15160,2017-06-05
2839,871603641970380801,Mon Jun 05 05:44:36 +0000 2017,"@commoboy @SpaceX Most people don't realize you can see Dragon approach the Space Station from the ground, even in LA",467,40,507,2017-06-05
2840,871407347339452416,Sun Jun 04 16:44:36 +0000 2017,Proud of my Mom ❤️ https://t.co/MY9dGfDo0d,10580,778,11358,2017-06-04
2841,871228411494014976,Sun Jun 04 04:53:34 +0000 2017,"@Pandora659 Yeah, pretty much dead center. We painted the target area with radio reflective paint, which helps the radar be more precise.",1572,135,1707,2017-06-04
2842,871227949302767616,Sun Jun 04 04:51:44 +0000 2017,@zlorena70 Exactly,832,10,842,2017-06-04
2843,871227498809368580,Sun Jun 04 04:49:56 +0000 2017,It's starting to feel kinda normal to reuse rockets. Good. That's how it is for cars &amp; airplanes and how it should be for rockets.,60216,11394,71610,2017-06-04
2844,871161167959408641,Sun Jun 04 00:26:22 +0000 2017,"RT @NASA: #ICYMI, more than 6,000 pounds of science &amp; supplies left planet Earth at 5:07pm ET to head to @Space_Station: https://t.co/BPi0N…",0,2250,2250,2017-06-04
2845,871076851900325888,Sat Jun 03 18:51:19 +0000 2017,First reflight of a Dragon spacecraft set for later today https://t.co/EW4HsWvlwc,12499,2155,14654,2017-06-03
2846,870570686409920512,Fri Jun 02 09:20:00 +0000 2017,@anandmahindra Good point :),3932,456,4388,2017-06-02
2847,870458928055803904,Fri Jun 02 01:55:55 +0000 2017,"RT @RobertIger: As a matter of principle, I've resigned from the President's Council over the  #ParisAgreement withdrawal.",0,52060,52060,2017-06-02
2848,870411649621999617,Thu Jun 01 22:48:03 +0000 2017,India commits to sell only electric cars by 2030. It is already the largest market for solar power. https://t.co/EGBNTPzmE5,58048,26026,84074,2017-06-01
2849,870380036750168065,Thu Jun 01 20:42:26 +0000 2017,"Under Paris deal, China committed to produce as much clean electricity by 2030 as the US does from all sources today https://t.co/F8Ppr2o7Rl",48436,17299,65735,2017-06-01
2850,870369915894546432,Thu Jun 01 20:02:13 +0000 2017,Am departing presidential councils. Climate change is real. Leaving Paris is not good for America or the world.,527936,221806,749742,2017-06-01
2851,870316194967859201,Thu Jun 01 16:28:45 +0000 2017,"RT @SpaceX: Falcon 9 and Dragon on Pad 39A at @NASAKennedy. Weather is 70% favorable for today’s 5:55 p.m. EDT, 21:55 UTC launch. https://t…",0,2727,2727,2017-06-01
2852,870316100696723456,Thu Jun 01 16:28:22 +0000 2017,@TrickyDickyChap Coming soon,200,3,203,2017-06-01
2853,870308385198981120,Thu Jun 01 15:57:43 +0000 2017,"RT @TheMarsSociety: Tomorrow, SpaceX Will Forever Transform Spaceflight https://t.co/4mB1jDWpCE via @Futurism",0,955,955,2017-06-01
2854,870183559666966528,Thu Jun 01 07:41:42 +0000 2017,@danekevincook Yeah :),1677,182,1859,2017-06-01
2855,869981724905619456,Wed May 31 18:19:41 +0000 2017,RT @insideclimate: BREAKING: Exxon Shareholders Approve Climate Resolution: 62% Call for Disclosure in Landmark Vote https://t.co/5W09f1Ixo…,0,2446,2446,2017-05-31
2856,869971423455924224,Wed May 31 17:38:45 +0000 2017,@schneby Will have no choice but to depart councils in that case,15388,3830,19218,2017-05-31
2857,869970236669177856,Wed May 31 17:34:02 +0000 2017,"Don't know which way Paris will go, but I've done all I can to advise directly to POTUS, through others in WH &amp; via councils, that we remain",63398,16684,80082,2017-05-31
2858,869798092895166464,Wed May 31 06:10:00 +0000 2017,@LilEdit @Nalepa And then some,245,12,257,2017-05-31
2859,869782701762502656,Wed May 31 05:08:50 +0000 2017,"@Taraustralis @VividSydney Yeah, it was great!",222,5,227,2017-05-31
2860,869781806467383297,Wed May 31 05:05:17 +0000 2017,Piggyback rides around the Opera House https://t.co/Z27JSVBt21,3476,238,3714,2017-05-31
2861,869781762452316162,Wed May 31 05:05:06 +0000 2017,Sydney is such a beautiful city https://t.co/AuCRqFHQwr,4449,320,4769,2017-05-31
2862,869076569876303872,Mon May 29 06:22:55 +0000 2017,@marlomajor A lot,3364,178,3542,2017-05-29
2863,869037783805046784,Mon May 29 03:48:48 +0000 2017,"@suzanakajtazaj I do via my foundation, which is now 16 years old, but my grants are (almost always) anonymous",352,21,373,2017-05-29
2864,868607810040242176,Sat May 27 23:20:14 +0000 2017,@AndyPabari Yes,173,27,200,2017-05-27
2865,868606773682356224,Sat May 27 23:16:07 +0000 2017,@CurtisHemming @swiftcurlibrary @lloydbrokeit @TeslaMotors Should finish trans-Canada this year. A stop in Swift Current for sure!,526,69,595,2017-05-27
2866,868055596037095424,Fri May 26 10:45:56 +0000 2017,@drewjohnarnold Yes,342,15,357,2017-05-26
2867,868045435071455233,Fri May 26 10:05:33 +0000 2017,"RT @OpenAI: We're releasing OpenAI Baselines, reliable implementations of RL algorithms. Today: DQN &amp; 3 variants: https://t.co/Mw0gCIwv1Z",0,1040,1040,2017-05-26
2868,868023177061978112,Fri May 26 08:37:07 +0000 2017,Comparing Model S vs Model 3 https://t.co/JPM9VVGbhA,6004,1650,7654,2017-05-26
2869,867988709727129604,Fri May 26 06:20:09 +0000 2017,Old-school fidget spinner back when the only things to play with were squirrels and rocks https://t.co/jx1Xc8nu7t,10474,2184,12658,2017-05-26
2870,867667009839931393,Thu May 25 09:01:50 +0000 2017,@FBeuster There will be a combined booster static fire. Maybe a few.,336,31,367,2017-05-25
2871,867634302330093570,Thu May 25 06:51:52 +0000 2017,"Btw, that cloud is almost entirely steam, including dark parts (like a storm). This is what the launch looks like: https://t.co/chrhsz5iwn",4356,618,4974,2017-05-25
2872,867632190695235584,Thu May 25 06:43:28 +0000 2017,"Falcon Heavy is this times three. One way or another, launch is guaranteed to be exciting ... https://t.co/FPUNALj0Hd",10109,1992,12101,2017-05-25
2873,867241481182093312,Wed May 24 04:50:56 +0000 2017,@station2stat @TeslaMotors Will shut that down. The point is to provide something special that only existing owners… https://t.co/2sRVQNZdjl,161,10,171,2017-05-24
2874,867239192774004738,Wed May 24 04:41:50 +0000 2017,@leonwang0091 Only if you want pure joy mainlined straight into your brain,304,31,335,2017-05-24
2875,867187932343304192,Wed May 24 01:18:09 +0000 2017,@andrewhockings You are right. Going at max speed. Not much time left.,640,51,691,2017-05-24
2876,867187366808633344,Wed May 24 01:15:54 +0000 2017,@pixelastronaut Busted,171,7,178,2017-05-24
2877,867186812497690624,Wed May 24 01:13:42 +0000 2017,@michaelknaepen Will keep the original Bond Lotus sub as-is. That design can't actually convert from car to sub. Ha… https://t.co/EAO3DJ3XmT,253,24,277,2017-05-24
2878,867146773562654720,Tue May 23 22:34:36 +0000 2017,@davidshepardson True :),110,1,111,2017-05-23
2879,867146453868724224,Tue May 23 22:33:20 +0000 2017,Feel exactly the same way as A.O. Scott. Particularly loved The Spy Who Loved Me https://t.co/Lar9pNj2Zi,3631,571,4202,2017-05-23
2880,866851007317155840,Tue May 23 02:59:20 +0000 2017,@ddkilzer @Irishjugg0 @MacBenTosh All Model S and X cars will have an auto raise and lower function for the steering wheel in a few months.,252,23,275,2017-05-23
2881,866798148303200256,Mon May 22 23:29:17 +0000 2017,@BigDAK54 I spoke directly with The President three weeks ago about Paris. Many others have too. Cautiously optimis… https://t.co/oMSaVawe86,1598,208,1806,2017-05-22
2882,866797334037807104,Mon May 22 23:26:03 +0000 2017,@WaldekKubicki @shazm01 Interesting idea. Would give a dynamic 360 deg surround view as you're driving. Have this i… https://t.co/98Q6dNNGuj,206,12,218,2017-05-22
2883,866796801994641408,Mon May 22 23:23:56 +0000 2017,"@sethjacob14 Early next year. To start with, we're making the simplest Model 3 first, like we did with S. Didn't do… https://t.co/2iMlEhLP6b",2106,197,2303,2017-05-22
2884,866794741186183171,Mon May 22 23:15:45 +0000 2017,@shazm01 We could add that function pretty easily from a technical standpoint. Just need to add in the billing software.,197,12,209,2017-05-22
2885,866794454731993089,Mon May 22 23:14:36 +0000 2017,"@douglasprest Can be set higher than that for highways, but limited to +5mph or +8km/h off highway (true avg drive… https://t.co/ReboS7LnXj",177,9,186,2017-05-22
2886,866793478616788992,Mon May 22 23:10:44 +0000 2017,RT @GeorgeTakei: Elon Musk's new venture looks anything but boring. @Mic https://t.co/wEDwJqSIM6,0,3487,3487,2017-05-22
2887,866507691644002304,Mon May 22 04:15:07 +0000 2017,@noradio @MCornell0 @marks22 Exactly,224,6,230,2017-05-22
2888,866482406160609280,Mon May 22 02:34:38 +0000 2017,@tony_lo Still on for end of year. Just software limited. Any Tesla car with HW2 (all cars built since Oct last yea… https://t.co/l79pZ9yZLI,339,34,373,2017-05-22
2889,866481510399881216,Mon May 22 02:31:05 +0000 2017,@freerobby @jetkohli There's just no way. Hundreds of parts and most of wiring harness would have to be replaced. W… https://t.co/DAIGILYnTS,257,11,268,2017-05-22
2890,866481163170349056,Mon May 22 02:29:42 +0000 2017,@marks22 HW2. HW1 doesn't have enough sensors and computing power.,219,15,234,2017-05-22
2891,866480832302555136,Mon May 22 02:28:23 +0000 2017,@harropj Hopefully June for those too,231,9,240,2017-05-22
2892,866480356412727298,Mon May 22 02:26:30 +0000 2017,@MacBenTosh S for sure. It is a bigger car.,136,6,142,2017-05-22
2893,866473736676950016,Mon May 22 02:00:11 +0000 2017,@jetkohli I'd highly recommend upgrading to latest Model S (which is approx version 4). Only if you really want a s… https://t.co/EeM18SPZWl,354,18,372,2017-05-22
2894,866473048639066112,Mon May 22 01:57:27 +0000 2017,"@TheAvinashSingh Maybe I'm misinformed, but I was told that 30% of parts must be locally sourced and the supply doe… https://t.co/HCcVRfDopa",447,161,608,2017-05-22
2895,866472504541368321,Mon May 22 01:55:18 +0000 2017,"@rrosenbl Yeah, control algorithm is safe, but unpleasant. New one is even safer, but super smooth.",413,17,430,2017-05-22
2896,866472074142822402,Mon May 22 01:53:35 +0000 2017,"@ethank Almost there, plus much improved web browser",434,18,452,2017-05-22
2897,866471925379235842,Mon May 22 01:52:59 +0000 2017,@kedyson1 That will be tied to deliveries of the first production cars in July,381,35,416,2017-05-22
2898,866471370418339840,Mon May 22 01:50:47 +0000 2017,@RITSPEX Almost there. Probably in a few months.,185,22,207,2017-05-22
2899,866470958059536384,Mon May 22 01:49:09 +0000 2017,"@BradMSimon @JonHaber You can easily turn it off in the car via settings, but that would beg the question of why you turned it off :)",226,10,236,2017-05-22
2900,866470572967903232,Mon May 22 01:47:37 +0000 2017,@lexiheft @HugoMeister42 Something cool for sure,288,19,307,2017-05-22
2901,866470387248316416,Mon May 22 01:46:53 +0000 2017,Excited about the Tesla Autopilot software release rolling out next month. New control algorithm feels as smooth as silk.,26625,4487,31112,2017-05-22
2902,866469349090926592,Mon May 22 01:42:45 +0000 2017,"@HugoMeister42 Model 3, Model X &amp; Model S will all have same level of Autopilot capability. It's just a matter of r… https://t.co/5qaBMGTegb",181,18,199,2017-05-22
2903,866468642950598658,Mon May 22 01:39:57 +0000 2017,@songcarver Wear underpants,273,29,302,2017-05-22
2904,866468411064201216,Mon May 22 01:39:02 +0000 2017,@JonHaber Will do,142,2,144,2017-05-22
2905,866468236686012416,Mon May 22 01:38:20 +0000 2017,@LeeGrayTeslaFan Black and textured slate versions will be,114,6,120,2017-05-22
2906,866467971018797056,Mon May 22 01:37:17 +0000 2017,RT @waitbutwhy: Good resource for people looking to dedicate themselves to the development of safe AI: https://t.co/hN0U0z3MKn,0,667,667,2017-05-22
2907,866171283167264770,Sun May 21 05:58:21 +0000 2017,@sleepsl8 Yes,164,8,172,2017-05-21
2908,865707097974951936,Fri May 19 23:13:50 +0000 2017,"@WorldAndScience For reason I can't explain, I find #2 especially odd. Also, not a fan of #17. Has led too many peo… https://t.co/IcKQzQZj8q",1581,189,1770,2017-05-19
2909,865705983141494785,Fri May 19 23:09:25 +0000 2017,"@waitbutwhy Still agree with Tim's points. What ""you"" are is an evolving, mind-body pattern, but there's still a co… https://t.co/YOg2wD4lbJ",604,70,674,2017-05-19
2910,865703866620272640,Fri May 19 23:01:00 +0000 2017,@waitbutwhy Heisenberg's uncertainty principle &amp; practical limits of simultaneity in transfer make this exact thoug… https://t.co/Jf4AWzAGFY,667,82,749,2017-05-19
2911,865312614082949123,Thu May 18 21:06:18 +0000 2017,RT @creepypuppet: Lady MERA swept in from the sea. First day with the exquisite Amber Heard. (Shot by the talented @jasinboland ) https://t…,0,9394,9394,2017-05-18
2912,864987115720818689,Wed May 17 23:32:53 +0000 2017,"RT @ElectrekCo: Volvo credits Tesla for creating EV demand, says they will stop developing diesel engines to focus on EVs https://t.co/Jdjm…",0,2238,2238,2017-05-17
2913,864722655651405825,Wed May 17 06:02:01 +0000 2017,@Fairaday We got stuck,457,11,468,2017-05-17
2914,864719823112032256,Wed May 17 05:50:46 +0000 2017,All the answers to questions you never asked about holes in the ground https://t.co/vXTeB9R7Uw,9924,3132,13056,2017-05-17
2915,864706617031278592,Wed May 17 04:58:17 +0000 2017,@Oliver_Brian What pun?,1594,42,1636,2017-05-17
2916,864705169618903040,Wed May 17 04:52:32 +0000 2017,What I love about The Boring Company are the low expectations. Nowhere to go but down.,43467,8868,52335,2017-05-17
2917,864675939367530496,Wed May 17 02:56:23 +0000 2017,T-boned in a Model X at 65 mph  https://t.co/vt6g89Z9rk,11456,2604,14060,2017-05-17
2918,864612311457124352,Tue May 16 22:43:33 +0000 2017,Moonlight Sonata https://t.co/HiuURSLsiU,4880,1145,6025,2017-05-16
2919,864541061364035584,Tue May 16 18:00:26 +0000 2017,Robots that learn by example from @OpenAI https://t.co/skXGB2mT6n,4632,1475,6107,2017-05-16
2920,864323162321833984,Tue May 16 03:34:34 +0000 2017,RT @SpaceX: Quick video recap of Falcon 9 launch of Inmarsat-5 Flight 4 https://t.co/W8eVUEsH6r,0,3265,3265,2017-05-16
2921,864323048576393216,Tue May 16 03:34:07 +0000 2017,"RT @OpenAI: Roboschool, open-source software for simulating robots, integrated with OpenAI Gym: https://t.co/FNPLqbb7vA.",0,900,900,2017-05-16
2922,864257650669649920,Mon May 15 23:14:15 +0000 2017,RT @SpaceX: Webcast of Falcon 9 launch is now live → https://t.co/gtC39uBC7z,0,893,893,2017-05-15
2923,864237320865628161,Mon May 15 21:53:28 +0000 2017,"RT @wcax: .@GreenMtnPower, Tesla team up on one-of-a-kind energy storage project in #Vt- @alexandrawcax has details https://t.co/0RC0ZH8apM…",0,273,273,2017-05-15
2924,863554048204480512,Sun May 14 00:38:23 +0000 2017,"@gmem_ It's sort of like a pickaxe if you use the claw side, but has the added advantage of also hammering",485,30,515,2017-05-14
2925,863553417301512193,Sun May 14 00:35:53 +0000 2017,"@BarakaMahili Gary the snail is like Speedy Gonzales on meth ... or ambien. One of the two. Either way, Godot, our… https://t.co/Exwv1NYs9a",2325,222,2547,2017-05-14
2926,863551997357703168,Sun May 14 00:30:14 +0000 2017,And ... it's done https://t.co/MBBSa04Eoc,13118,1698,14816,2017-05-14
2927,863551370892238848,Sun May 14 00:27:45 +0000 2017,Worked in Minecraft. Just sayin ...,13545,1946,15491,2017-05-14
2928,863551105296252928,Sun May 14 00:26:42 +0000 2017,@UJustGotCarled Of course. Why is that even a question?,642,145,787,2017-05-14
2929,863550784012558337,Sun May 14 00:25:25 +0000 2017,Imma gonna dig that tunnel with this here hammer,10183,1459,11642,2017-05-14
2930,863225206390669312,Sat May 13 02:51:41 +0000 2017,@AndrewHws My grandmother was from Moose Jaw,422,29,451,2017-05-13
2931,863224909480157184,Sat May 13 02:50:31 +0000 2017,@gleesin Going to a barn raising!,885,14,899,2017-05-13
2932,863222555208851456,Sat May 13 02:41:09 +0000 2017,"On my cousin's farm in Canada at 17, wearing a hat on a hat https://t.co/U96ClGz5gZ",53454,6937,60391,2017-05-13
2933,863218707786420224,Sat May 13 02:25:52 +0000 2017,"@jewhittingham Yeah, worked on the farm when I was 17",345,13,358,2017-05-13
2934,863218452567175168,Sat May 13 02:24:51 +0000 2017,"Family history article. Was born in South Africa, but named after my American great-grandfather. https://t.co/Q1d7hP763T",6495,1225,7720,2017-05-13
2935,863017106824060928,Fri May 12 13:04:47 +0000 2017,@BecauseImAsh Yes,270,25,295,2017-05-12
2936,863014220282998788,Fri May 12 12:53:18 +0000 2017,"[Warning, this may cause motion sickness or seizures]
This is a test run of our electric sled… https://t.co/vI3hLirzg9",13320,4892,18212,2017-05-12
2937,863014180835610625,Fri May 12 12:53:09 +0000 2017,"The race between Gary, our pet snail who lives in a pineapple, and Godot, our tunnel boring… https://t.co/IES65Y99gJ",4935,861,5796,2017-05-12
2938,863014142763966464,Fri May 12 12:53:00 +0000 2017,Boring machine segments have been lowered into the starter tunnel. Going through final assembly.… https://t.co/2jg03I7j4n,2914,430,3344,2017-05-12
2939,863014096337162241,Fri May 12 12:52:49 +0000 2017,Cutterhead in operation at standard industry speed. Planning to jack this up by a factor of ten… https://t.co/K8LcnhLCCA,2418,347,2765,2017-05-12
2940,863014053798567936,Fri May 12 12:52:39 +0000 2017,First tunnel for The Boring Company begins ... Full length of first tunnel will run from LAX to… https://t.co/Dbf2nkHfb2,4075,887,4962,2017-05-12
2941,863007360901455872,Fri May 12 12:26:03 +0000 2017,"Entry hole, staging area and starting tunnel for Boring Machine 1 (aka Godot) now complete https://t.co/8taxTMDcDV",4443,805,5248,2017-05-12
2942,862849689204301824,Fri May 12 01:59:31 +0000 2017,"@samgalaviz_ Tesla needs to iterate fast on solar roof prefab/install technology, so all installs will be done by Tesla techs at first",178,10,188,2017-05-12
2943,862573738222432256,Thu May 11 07:42:59 +0000 2017,@Tragik187 Third one will be from Frost. Maybe the second.,262,13,275,2017-05-11
2944,862573249430814720,Thu May 11 07:41:03 +0000 2017,@Armstrong_Anth Yes. Good.,159,7,166,2017-05-11
2945,862572672676356096,Thu May 11 07:38:45 +0000 2017,"First machine is Godot. Still waiting ... Don't know why, when or where.",8097,1128,9225,2017-05-11
2946,862571929345048581,Thu May 11 07:35:48 +0000 2017,Naming theme for tunnel boring machines will be poems &amp; plays. Decided against plays &amp; poems. Too obvious.,7499,857,8356,2017-05-11
2947,862421991617306624,Wed May 10 21:40:00 +0000 2017,@sahilmalik That's how the tiles sit on the roof. There is no difference in strength for the Tesla tile based on or… https://t.co/SFdjBuUwpp,273,22,295,2017-05-10
2948,862401961550692352,Wed May 10 20:20:24 +0000 2017,@Lee_Ars This is true. The economics are not yet compelling where housing and utility costs are low and property taxes are high.,203,15,218,2017-05-10
2949,862392836993560580,Wed May 10 19:44:09 +0000 2017,Slo-mo hail cannonball impacting Tesla solar roof tile https://t.co/MMBAcUD9iC,5762,1225,6987,2017-05-10
2950,862381399122128897,Wed May 10 18:58:42 +0000 2017,"@cubamark Will do our best. Hopefully, yes.",200,7,207,2017-05-10
2951,862380825265848321,Wed May 10 18:56:25 +0000 2017,RT @TeslaMotors: Solar Roof https://t.co/IIk7XVw10O,0,5093,5093,2017-05-10
2952,862380425607499776,Wed May 10 18:54:50 +0000 2017,"RT @business: Tesla just released solar roof prices, and they're cheaper than expected https://t.co/V5gUUoeKm9 https://t.co/C5UpXb2fS5",0,3317,3317,2017-05-10
2953,862380031263162368,Wed May 10 18:53:16 +0000 2017,RT @ElectrekCo: Tesla releases details of its solar roof tiles: cheaper than regular roof with 'infinity warranty' https://t.co/iBGQcIFtuP…,0,1940,1940,2017-05-10
2954,862221037835919361,Wed May 10 08:21:29 +0000 2017,@doogooroo Yes,291,7,298,2017-05-10
2955,862216356258758662,Wed May 10 08:02:53 +0000 2017,Solar roof can be ordered for almost any country. Deployment this year in the US and overseas next year.,21153,5877,27030,2017-05-10
2956,862215874186428416,Wed May 10 08:00:58 +0000 2017,@chriscardinal Black glass smooth and textured will be first. Tuscan and French Slate in about six months.,346,39,385,2017-05-10
2957,862215563912765440,Wed May 10 07:59:44 +0000 2017,@torbenanderson U.K. delivery and installation next year,298,25,323,2017-05-10
2958,862215023594098688,Wed May 10 07:57:35 +0000 2017,@nathanrodger Yes,278,3,281,2017-05-10
2959,862214675039010816,Wed May 10 07:56:12 +0000 2017,Tesla solar glass roof orders open this afternoon. I think it will be great. More in about 10 hours ...,18102,4200,22302,2017-05-10
2960,862074419996278784,Tue May 09 22:38:52 +0000 2017,"If heat death of the universe is the destination, it really is all about the journey https://t.co/icmkmMKhvj https://t.co/0JmKUYAFRq",6449,1584,8033,2017-05-09
2961,862073475963379712,Tue May 09 22:35:07 +0000 2017,@GeorgeChiesa It's a good one,151,9,160,2017-05-09
2962,861345412023595008,Sun May 07 22:22:03 +0000 2017,@jovanik21 Thanks for doing it!,249,8,257,2017-05-07
2963,861271994288832514,Sun May 07 17:30:19 +0000 2017,Headed to see Guardians 2 w my bro and kids. Loved the first one.,26324,1654,27978,2017-05-07
2964,860400588311244801,Fri May 05 07:47:40 +0000 2017,"@keithdcohen I do love Banks, but perhaps we should reserve his names for the droneships",445,28,473,2017-05-05
2965,860397510447120384,Fri May 05 07:35:26 +0000 2017,@zanesloanbc Simple. I like it.,476,13,489,2017-05-05
2966,860396632361152512,Fri May 05 07:31:57 +0000 2017,Kinda like Snoop Dug,10730,1804,12534,2017-05-05
2967,860379071414321152,Fri May 05 06:22:10 +0000 2017,@AndrewHws I don't want to be presumptuous,1613,76,1689,2017-05-05
2968,860378029515718660,Fri May 05 06:18:01 +0000 2017,"I know what you're thinking … then why not ""the Third""? Well, I've learned my lesson about 3's.",8058,655,8713,2017-05-05
2969,860377370171121666,Fri May 05 06:15:24 +0000 2017,"@reviewero By calling it ""the Second"", it has more credibility",4740,420,5160,2017-05-05
2970,860375279570567168,Fri May 05 06:07:06 +0000 2017,"Maybe Ultimate Boring Machine, the Second",8065,1113,9178,2017-05-05
2971,860374746382217216,Fri May 05 06:04:59 +0000 2017,@ivanmartinsanz Boring Not Boring,504,29,533,2017-05-05
2972,860374338700099584,Fri May 05 06:03:21 +0000 2017,@ivanmartinsanz Good one,485,8,493,2017-05-05
2973,860373996381937664,Fri May 05 06:02:00 +0000 2017,@hunterbarnes144 Been done,899,31,930,2017-05-05
2974,860373617841807360,Fri May 05 06:00:30 +0000 2017,Thinking about a name for our first tunneling machine …,14157,2485,16642,2017-05-05
2975,860050049509736448,Thu May 04 08:34:45 +0000 2017,Was just rereading one of my favorites. So beautiful … https://t.co/gp0aNnWxcM,4944,809,5753,2017-05-04
2976,859504157148930048,Tue May 02 20:25:34 +0000 2017,RT @MrJc2012: What can I say. P100D is the best car I have ever driven. It's hard to put into words. Ludicrous mode is just nuts. Thank you…,0,413,413,2017-05-02
2977,859043148923678720,Mon May 01 13:53:41 +0000 2017,"Close-up of rocket stage separation, fast flip, boostback burn in a ring of fire and then… https://t.co/RM8kDgazVX",13711,5116,18827,2017-05-01
2978,859040909299556352,Mon May 01 13:44:47 +0000 2017,Landing https://t.co/m8DH1DkvFO,10524,3504,14028,2017-05-01
2979,859016221106225152,Mon May 01 12:06:41 +0000 2017,RT @SpaceX: Split screen shot of Falcon 9 first stage as it returns to Earth and lands at Landing Zone 1. https://t.co/5hlwTOTGKa,0,8583,8583,2017-05-01
2980,859008563519160320,Mon May 01 11:36:15 +0000 2017,"Launch and landing of the NRO spy satellite was good. Tough call, as high altitude wind shear was at 98.6% of the t… https://t.co/4JatnznfML",12239,2519,14758,2017-05-01
2981,859006158345879552,Mon May 01 11:26:42 +0000 2017,RT @SpaceX: Falcon 9 first stage has landed at LZ-1 https://t.co/gtC39uBC7z https://t.co/766RxdZ99X,0,3736,3736,2017-05-01
2982,859002489730994176,Mon May 01 11:12:07 +0000 2017,"Winds aloft are unusually high (still within structural safety bounds). Worrying, but not a showstopper. https://t.co/epHQQvajOZ",5122,645,5767,2017-05-01
2983,858908487018926080,Mon May 01 04:58:35 +0000 2017,"@VoltzCoreAudio Yeah, will probably publish an update in six weeks or so",454,42,496,2017-05-01
2984,858905558908190720,Mon May 01 04:46:57 +0000 2017,"My boring TED talk
https://t.co/QNgolyJXMr",29354,10092,39446,2017-05-01
2985,858904665181667328,Mon May 01 04:43:24 +0000 2017,RT @mashable: Elon Musk says we're only 2 years from being able to nap in self-driving cars https://t.co/koRwgpoYiM https://t.co/Yob6HyaXnK,0,2126,2126,2017-05-01
2986,858489574288379904,Sun Apr 30 01:13:59 +0000 2017,"RT @SpaceX: Falcon 9 and NROL-76 vertical on Pad 39-A. Launch window opens tomorrow at 7:00 a.m. EDT, 11:00 UTC. https://t.co/9o3ZMbaev7",0,2378,2378,2017-04-30
2987,858393753928609792,Sat Apr 29 18:53:13 +0000 2017,"RT @350: The #ClimateMarch in Washington DC is moving through the streets, and it is HUGE. https://t.co/tFSme9r7jh",0,20483,20483,2017-04-29
2988,858063290039115777,Fri Apr 28 21:00:05 +0000 2017,@williamlegate Couldn't agree more,2246,138,2384,2017-04-28
2989,858063095268130816,Fri Apr 28 20:59:18 +0000 2017,@batfflck Extremely,759,23,782,2017-04-28
2990,858062753889533952,Fri Apr 28 20:57:57 +0000 2017,Even more boring https://t.co/EfrzLAXwxs,20500,8588,29088,2017-04-28
2991,858052804606177280,Fri Apr 28 20:18:25 +0000 2017,Boring https://t.co/TBnhgPYWud,18410,4572,22982,2017-04-28
2992,857427686104289280,Thu Apr 27 02:54:25 +0000 2017,RT @XHNews: Chinese Vice Premier Wang Yang meets with Tesla CEO Elon Musk in Beijing https://t.co/HSM5kxBvYF,0,747,747,2017-04-27
2993,857412023847600128,Thu Apr 27 01:52:11 +0000 2017,"@kmckelly @cstross @jephjacques We def want to avoid either, particularly Surface Detail ...",172,11,183,2017-04-27
2994,856562879633522689,Mon Apr 24 17:37:59 +0000 2017,RT @TeslaMotors: Charging is our priority. This year we’re doubling our Supercharger network &amp; adding more chargers to existing sites https…,0,2688,2688,2017-04-24
2995,856552061839781888,Mon Apr 24 16:55:00 +0000 2017,@PJWU8 @creepypuppet @cowanfilms On it now,205,12,217,2017-04-24
2996,856551111301505024,Mon Apr 24 16:51:13 +0000 2017,"@moomoodining @creepypuppet @cowanfilms Great food, great ambience and with great friends. We all really enjoyed the visit.",204,9,213,2017-04-24
2997,856354252209442817,Mon Apr 24 03:48:58 +0000 2017,@JudeBurger @realamberheard @teslaownersau Will definitely do that on my next trip,288,16,304,2017-04-24
2998,856302986800369664,Mon Apr 24 00:25:16 +0000 2017,RT @realamberheard: https://t.co/ayTosQoe0a,0,5216,5216,2017-04-24
2999,856292321364631554,Sun Apr 23 23:42:53 +0000 2017,"Having moo moo at Moo Moo Gold Coast with amberheard, @CreepyPuppet and @CowanFilms https://t.co/SUM2RYYN7O",3476,330,3806,2017-04-23
3000,856196719746457602,Sun Apr 23 17:23:00 +0000 2017,@juancarlosrs @elpilot That is the aspiration: to avoid AI becoming other.,350,47,397,2017-04-23
3001,855161676705824768,Thu Apr 20 20:50:06 +0000 2017,RT @waitbutwhy: It's finally here: the full story on Neuralink. I knew the future would be nuts but this is a whole other level. https://t.…,0,5626,5626,2017-04-20
3002,854775938654928896,Wed Apr 19 19:17:19 +0000 2017,RT @TeslaMotors: Tesla driver walks away unscathed after ~500-ft fall from a cliff in his Model S. https://t.co/DqnsUgCHKh via @ElectrekCo,0,3199,3199,2017-04-19
3003,854413994072748032,Tue Apr 18 19:19:05 +0000 2017,RT @AAAauto: .@TeslaMotors Model X 75D-Overall Winner of the 2017 AAA Green Car Guide. More info on the winners &amp; car reviews: https://t.co…,0,1261,1261,2017-04-18
3004,854149536524021760,Tue Apr 18 01:48:13 +0000 2017,"@FredericLambert @TaylorSMarks @FlipperB @pkingdesign Yeah, sorry I missed that. This would only work for 75 kWh pa… https://t.co/TaO8BRitJM",228,16,244,2017-04-18
3005,854084819965194240,Mon Apr 17 21:31:03 +0000 2017,@FlipperB @pkingdesign Yes,165,10,175,2017-04-17
3006,854038254982619136,Mon Apr 17 18:26:01 +0000 2017,@pkingdesign Tesla will soon be offering a compelling means of upgrading a 60 to a 75,250,21,271,2017-04-17
3007,852582182212194304,Thu Apr 13 18:00:07 +0000 2017,@gucci_mau July,923,156,1079,2017-04-13
3008,852581322451111936,Thu Apr 13 17:56:42 +0000 2017,@NoahMagel Pickup truck unveil in 18 to 24 months,3215,903,4118,2017-04-13
3009,852581046625345536,Thu Apr 13 17:55:36 +0000 2017,@SamGonzales Next gen Roadster will be convertible,2952,476,3428,2017-04-13
3010,852580027178696704,Thu Apr 13 17:51:33 +0000 2017,Tesla Semi truck unveil set for September. Team has done an amazing job. Seriously next level.,53921,15849,69770,2017-04-13
3011,852248614021746688,Wed Apr 12 19:54:38 +0000 2017,@danahull @Reuters Yeah,193,16,209,2017-04-12
3012,852243718094561280,Wed Apr 12 19:35:10 +0000 2017,"@Reuters Besides, I already said we'd add more independent members during SCTY merger. Will announce soon, but this… https://t.co/gbjw6J54jg",497,58,555,2017-04-12
3013,852241941546778624,Wed Apr 12 19:28:07 +0000 2017,@Reuters This investor group should buy Ford stock. Their governance is amazing ...,1397,351,1748,2017-04-12
3014,852239986388721664,Wed Apr 12 19:20:21 +0000 2017,Autolist survey finds Tesla used car values are highest and sell fastest https://t.co/KcXFhqwXVa,8339,1762,10101,2017-04-12
3015,850453029987917824,Fri Apr 07 20:59:37 +0000 2017,"@chairheadMD @cheron Fairing is ~$5M, but that should be reusable this year. Am fairly confident we can reuse upper… https://t.co/VPj9dbWm21",873,232,1105,2017-04-07
3016,850452066992504832,Fri Apr 07 20:55:48 +0000 2017,@SeanRowley2 Latency should only be 5 min max. Checking ...,191,12,203,2017-04-07
3017,850386820793643008,Fri Apr 07 16:36:32 +0000 2017,Feature coming soon that allows one touch access to all discovered Tesla Easter eggs https://t.co/oWU6oq9Jqb,6497,1014,7511,2017-04-07
3018,850048221665558528,Thu Apr 06 18:11:03 +0000 2017,RT @OpenAI: A neural network teaches itself to analyze sentiment after only being trained to predict the next character: https://t.co/hrITH…,0,1919,1919,2017-04-06
3019,849636868052275200,Wed Apr 05 14:56:29 +0000 2017,And so the robots spared humanity ... https://t.co/v7JUJQWfCv,22394,6523,28917,2017-04-05
3020,848988730585096192,Mon Apr 03 20:01:01 +0000 2017,"@ForIn2020 @waltmossberg @mims @defcon_5 Exactly. Tesla is absurdly overvalued if based on the past, but that's irr… https://t.co/qQcTqkzgMl",1669,569,2238,2017-04-03
3021,848943072423497728,Mon Apr 03 16:59:35 +0000 2017,"@waltmossberg @mims @defcon_5 Et tu, Walt?",849,89,938,2017-04-03
3022,848935705057280001,Mon Apr 03 16:30:19 +0000 2017,Stormy weather in Shortville ...,11377,3177,14554,2017-04-03
3023,848416049573658624,Sun Apr 02 06:05:23 +0000 2017,@DaveLeeBBC @verge Coal is dying due to nat gas fracking. It's basically dead.,1063,236,1299,2017-04-02
3024,848415731502923777,Sun Apr 02 06:04:07 +0000 2017,@Lexxxzis It's just a helicopter in helicopter's clothing,425,44,469,2017-04-02
3025,848415356263702528,Sun Apr 02 06:02:38 +0000 2017,@verge It won't matter,1566,221,1787,2017-04-02
3026,848398971139629057,Sun Apr 02 04:57:31 +0000 2017,@SuperCoolCube Pretty good,349,23,372,2017-04-02
3027,848244577521647616,Sat Apr 01 18:44:01 +0000 2017,"Why did we waste so much time developing silly rockets? Damn you, aliens! So obtuse! You have all this crazy tech, but can't speak English!?",16447,3781,20228,2017-04-01
3028,848243350993895424,Sat Apr 01 18:39:09 +0000 2017,Technology breakthrough: turns out chemtrails are actually a message from time-traveling aliens describing the secret of teleportation,30611,9387,39998,2017-04-01
3029,848239928043491328,Sat Apr 01 18:25:33 +0000 2017,RT @OpenAI: We've created the world's first Spam-detecting AI trained entirely in simulation and deployed on a physical robot: https://t.co…,0,1054,1054,2017-04-01
3030,848239664536223745,Sat Apr 01 18:24:30 +0000 2017,RT @ProfBrianCox: This is extremely important from @elonmusk and @SpaceX - reusable rockets bring us MUCH closer to becoming a spacefaring…,0,1169,1169,2017-04-01
3031,848036043240636417,Sat Apr 01 04:55:23 +0000 2017,"@adamsbj Def P100D with Ludicrous+, although the rocket starts going a lot faster after that",361,31,392,2017-04-01
3032,847958571895619584,Fri Mar 31 23:47:32 +0000 2017,@BadAstronomer We can def bring it back like Dragon. Just a question of how much weight we need to add.,596,66,662,2017-03-31
3033,847890916048338946,Fri Mar 31 19:18:42 +0000 2017,@tesla_addict @TeslaMotors Working on it,295,23,318,2017-03-31
3034,847884776719740928,Fri Mar 31 18:54:18 +0000 2017,@jasonlamb Looks like it could do 20% more with some structural upgrades to handle higher loads. But that's in fully expendable mode.,301,25,326,2017-03-31
3035,847884413706874880,Fri Mar 31 18:52:51 +0000 2017,@cheron A lot,676,30,706,2017-03-31
3036,847884351375372288,Fri Mar 31 18:52:36 +0000 2017,@Cardoso Silliest thing we can imagine! Secret payload of 1st Dragon flight was a giant wheel of cheese. Inspired b… https://t.co/68nMJkiPsC,1815,289,2104,2017-03-31
3037,847883435100299267,Fri Mar 31 18:48:58 +0000 2017,"@redletterdave Good point, odds go from 0% to &gt;0% :)",627,32,659,2017-03-31
3038,847882909906341888,Fri Mar 31 18:46:53 +0000 2017,Falcon Heavy test flight currently scheduled for late summer,7756,1231,8987,2017-03-31
3039,847882289581359104,Fri Mar 31 18:44:25 +0000 2017,"Considering trying to bring upper stage back on Falcon Heavy demo flight for full reusability. Odds of success low, but maybe worth a shot.",15582,2670,18252,2017-03-31
3040,847881536254955521,Fri Mar 31 18:41:25 +0000 2017,@oxfordteddy Browser is already a little better. Kernel and browser update in prob 6 weeks or so (lots of underlyin… https://t.co/XtgQGwJ21D,199,17,216,2017-03-31
3041,847610880506208257,Fri Mar 31 00:45:56 +0000 2017,RT @SpaceX: More photos from today’s Falcon 9 launch and first stage landing → https://t.co/095WHX44BX https://t.co/c3UYhMrDec,0,4193,4193,2017-03-31
3042,847608431582208000,Fri Mar 31 00:36:12 +0000 2017,@BadAstronomer @SpaceX Thanks Phil!,862,43,905,2017-03-31
3043,847594208219336705,Thu Mar 30 23:39:41 +0000 2017,Incredibly proud of the SpaceX team for achieving this milestone in space! Next goal is reflight within 24 hours.,51251,13068,64319,2017-03-30
3044,847580067446345728,Thu Mar 30 22:43:30 +0000 2017,RT @SpaceX: Falcon 9 first stage has landed on Of Course I Still Love You — world’s first reflight of an orbital class rocket.,0,22751,22751,2017-03-30
3045,847561780532523008,Thu Mar 30 21:30:50 +0000 2017,RT @SpaceX: ~60 minutes until launch window for SES-10 opens. All systems and weather are go. Watch here → https://t.co/gtC39uBC7z https://…,0,2218,2218,2017-03-30
3046,847510437054877698,Thu Mar 30 18:06:48 +0000 2017,"RT @SpaceX: Falcon 9 and SES-10 vertical on Kennedy Space Center’s historic Pad 39A. Launch window opens at 6:27pm EDT, 10:27pm UTC. https:…",0,3083,3083,2017-03-30
3047,847234747747020800,Wed Mar 29 23:51:19 +0000 2017,"If you just downloaded V8.1, tap the the T on center screen three times",5305,750,6055,2017-03-29
3048,847178475970547712,Wed Mar 29 20:07:43 +0000 2017,"@drmanejwala @arctechinc On center screen. Also, center screen *will* show speed as an overlay that changes opacity according to relevance.",221,24,245,2017-03-29
3049,846772378067648513,Tue Mar 28 17:14:01 +0000 2017,@danahull Very few. We have yet to do a China (or Europe) launch of Model 3.,211,18,229,2017-03-28
3050,846770102502473728,Tue Mar 28 17:04:59 +0000 2017,@business Glad to have Tencent as an investor and advisor to Tesla,570,104,674,2017-03-28
3051,846768497904369664,Tue Mar 28 16:58:36 +0000 2017,@nickg_uk @chouky02 No,321,32,353,2017-03-28
3052,846768171486855169,Tue Mar 28 16:57:18 +0000 2017,@nickg_uk @chouky02 You won't care,380,27,407,2017-03-28
3053,846668569576259584,Tue Mar 28 10:21:31 +0000 2017,@NakatomiTim What gave me away?,669,32,701,2017-03-28
3054,846668345998925826,Tue Mar 28 10:20:38 +0000 2017,@nickg_uk No,808,71,879,2017-03-28
3055,846667837716410368,Tue Mar 28 10:18:37 +0000 2017,Here is the latest SpaceX travel ad for the flight around the moon &amp; into deep space. Maybe needs a few edits ... https://t.co/mA8ZgutrbE,9289,2242,11531,2017-03-28
3056,846580443797368832,Tue Mar 28 04:31:21 +0000 2017,"Long Neuralink piece coming out on @waitbutwhy in about a week. Difficult to dedicate the time, but existential risk is too high not to.",12635,3610,16245,2017-03-28
3057,845447146111303681,Sat Mar 25 01:28:01 +0000 2017,RT @OpenAI: New research release: overcoming many of Reinforcement Learning's limitations with Evolution Strategies: https://t.co/fVIStOFdoU,0,1143,1143,2017-03-25
3058,845403535353143299,Fri Mar 24 22:34:44 +0000 2017,@erikhaaland We cannot make all country versions simultaneously or the production start would be a disaster. You would get first in Norway.,278,24,302,2017-03-24
3059,845402066629517312,Fri Mar 24 22:28:54 +0000 2017,@Isabelle_Kent Yes,192,7,199,2017-03-24
3060,845370779298521088,Fri Mar 24 20:24:34 +0000 2017,@D1sneyNut Yes,201,6,207,2017-03-24
3061,845355766357737472,Fri Mar 24 19:24:55 +0000 2017,@nickbaum I believe so,228,13,241,2017-03-24
3062,845337811876114432,Fri Mar 24 18:13:34 +0000 2017,@nddugan Yup,182,8,190,2017-03-24
3063,845331893176324096,Fri Mar 24 17:50:03 +0000 2017,@Mr_Ewe_Guy Oh so little faith,1808,104,1912,2017-03-24
3064,845325721455149056,Fri Mar 24 17:25:32 +0000 2017,@kryniog The shorter wheelbase only allows for a 75 kWh pack in Model 3 at current cell/module energy densities,330,58,388,2017-03-24
3065,845294849049870337,Fri Mar 24 15:22:51 +0000 2017,"RT @PokerVixen: @elonmusk I'm so unbelievably happy with my Model S. When people ask if l like it I respond ""No, I love it! 😍 it's amazing!…",0,223,223,2017-03-24
3066,845294411072204801,Fri Mar 24 15:21:07 +0000 2017,"RT @RH_Way: @elonmusk Our 85 hit the guardrails at well over 160km/h. Tessi absorbed impact, wife and baby are ok. Best car ever &amp; Member o…",0,423,423,2017-03-24
3067,845294161125269505,Fri Mar 24 15:20:07 +0000 2017,@ToddGerkens Yeah,270,9,279,2017-03-24
3068,845293825715154945,Fri Mar 24 15:18:47 +0000 2017,@HolsMichael Start taking orders in April,468,90,558,2017-03-24
3069,845293157977767937,Fri Mar 24 15:16:08 +0000 2017,"@dr_angus Yeah, probably a year from now. S will still win on acceleration though, due to having more space for a larger battery.",311,23,334,2017-03-24
3070,845292886623109120,Fri Mar 24 15:15:03 +0000 2017,"RT @morrisonbrett: @elonmusk First batch Model S P85D for me, Grey. Signature Model X P90D for wife, Triple White. Best vehicles in the wor…",0,70,70,2017-03-24
3071,845292269649354752,Fri Mar 24 15:12:36 +0000 2017,"@akaWrecks @ckalapala Only Model S will have the seven seater option, more cargo space, plus higher range, accelera… https://t.co/3wucaZRkZa",265,24,289,2017-03-24
3072,845291692206960641,Fri Mar 24 15:10:18 +0000 2017,RT @arctechinc: @elonmusk we believe so much in Tesla and its goals we have a 100D Model S and 90D Model X and love both. Thank you! https:…,0,149,149,2017-03-24
3073,845291536480813056,Fri Mar 24 15:09:41 +0000 2017,@CamKode The Model S produced today is arguably version 4. Let me put it this way: it is the car I will keep drivin… https://t.co/xAxvz9TxpA,324,37,361,2017-03-24
3074,845291064583892992,Fri Mar 24 15:07:49 +0000 2017,RT @Herifin_teki: @elonmusk My lil monster Tesla Model X is the best car I've ever used. Thank you Elon. ❤️,0,66,66,2017-03-24
3075,845290713776451584,Fri Mar 24 15:06:25 +0000 2017,"@BlueBowles If fate is on our side, it will be amazing. Will talk about that in detail next week.",598,55,653,2017-03-24
3076,845290493130919936,Fri Mar 24 15:05:32 +0000 2017,@juanmlemao No problem :),400,25,425,2017-03-24
3077,845290417591541760,Fri Mar 24 15:05:14 +0000 2017,"@DJBurges Should be summer next year. Sorry, really wish we could get RHD done sooner. We truly are working as fast as we can.",385,30,415,2017-03-24
3078,845289977051148289,Fri Mar 24 15:03:29 +0000 2017,@faultywarrior @matt_trulli @FredericLambert @TimShelton @JimPengelly Let me just go fetch my magic wand ...,493,35,528,2017-03-24
3079,845289583575105536,Fri Mar 24 15:01:56 +0000 2017,RT @RicardoTwumasi: @elonmusk My Tesla Model S is the best car I've ever had https://t.co/OBkDjOPrUo,0,103,103,2017-03-24
3080,845287981652963328,Fri Mar 24 14:55:34 +0000 2017,"@TimShelton @FredericLambert @JimPengelly First in line for dual motor as soon as we can make it, which is probably in 6 to 9 months.",296,31,327,2017-03-24
3081,845287688882184192,Fri Mar 24 14:54:24 +0000 2017,@meangene2030 Damn straight we do! Coming with 8.1 next week.,436,22,458,2017-03-24
3082,845287211306139648,Fri Mar 24 14:52:30 +0000 2017,First drive of a release candidate version of Model 3 https://t.co/zcs6j1YRa4,32297,10902,43199,2017-03-24
3083,845286730668257280,Fri Mar 24 14:50:35 +0000 2017,@FredericLambert It still has one display,239,17,256,2017-03-24
3084,845286206539685890,Fri Mar 24 14:48:30 +0000 2017,@VoltzCoreAudio Nothing majorly new that a consumer would notice. Lots of new tech in the design and production process though.,186,16,202,2017-03-24
3085,845285846936825856,Fri Mar 24 14:47:05 +0000 2017,"@arctechinc The more autonomous a car is, the less dash info you need. How often do you look at the instrument pane… https://t.co/Ie6abxs7LD",721,143,864,2017-03-24
3086,845285398662197248,Fri Mar 24 14:45:18 +0000 2017,@asimo3089 How about the video we just took of the first Model 3 release candidate drive?,463,25,488,2017-03-24
3087,845285144436998144,Fri Mar 24 14:44:17 +0000 2017,RT @bobbykansara: @MrThorman @elonmusk My Model X is the greatest thing I have ever purchased. Period.,0,73,73,2017-03-24
3088,845285007211950080,Fri Mar 24 14:43:45 +0000 2017,"@trabru Yup, machine arrives next month and we start digging the tunnel!",417,30,447,2017-03-24
3089,845284550926221312,Fri Mar 24 14:41:56 +0000 2017,@oakhaller I think so,145,6,151,2017-03-24
3090,845284390397665280,Fri Mar 24 14:41:17 +0000 2017,"@FredericLambert @JimPengelly No, we are minimizing configuration complexity to keep the production ramp on schedul… https://t.co/REhQOY149t",308,32,340,2017-03-24
3091,845283880080850945,Fri Mar 24 14:39:16 +0000 2017,@Trojan81 Tues/Wed,109,4,113,2017-03-24
3092,845283534948392960,Fri Mar 24 14:37:53 +0000 2017,@jDaz Because I was a dumb idiot and didn't realize at the time that it would cause confusion,1476,175,1651,2017-03-24
3093,845283253602828288,Fri Mar 24 14:36:46 +0000 2017,@timothymjr Tues/Wed next week,151,9,160,2017-03-24
3094,845282934546350080,Fri Mar 24 14:35:30 +0000 2017,"@Skate_a_book Yes. Model S will always be the fastest Tesla until next gen Roadster, which is a few years away.",498,47,545,2017-03-24
3095,845282733546921985,Fri Mar 24 14:34:42 +0000 2017,"@JimPengelly Yes, but not until next year",236,10,246,2017-03-24
3096,845282590030360578,Fri Mar 24 14:34:08 +0000 2017,@AlSaibie Yes. Hardware already on all production S and X cars.,174,9,183,2017-03-24
3097,845282298291339267,Fri Mar 24 14:32:59 +0000 2017,"@theKen_Miller Sorta. Model 3 is like a BMW 3 series or Audi A4. Model S is like BMW 5 and 6 series, but much faste… https://t.co/m7gxmtjGrZ",488,55,543,2017-03-24
3098,845281640972660736,Fri Mar 24 14:30:22 +0000 2017,@Greg525 How about now?,431,13,444,2017-03-24
3099,845281547368349696,Fri Mar 24 14:30:00 +0000 2017,@varunfatehpuria Oh Model Y is coming too in a few years. Kinda have to.,748,92,840,2017-03-24
3100,845281211626864641,Fri Mar 24 14:28:40 +0000 2017,@luciojr All Tesla cars built since Oct last year will be capable of self-driving as software improves,292,27,319,2017-03-24
3101,845280846764396544,Fri Mar 24 14:27:13 +0000 2017,@swindeez Definitely,261,9,270,2017-03-24
3102,845280754871418880,Fri Mar 24 14:26:51 +0000 2017,"Model 3 was going to be called Model E, for obvious dumb humor reasons, but Ford sued to block it, so now it is S3X. Totally different :)",40498,12995,53493,2017-03-24
3103,845279897383710720,Fri Mar 24 14:23:26 +0000 2017,@TimBeiko Yes,257,9,266,2017-03-24
3104,845279423238590464,Fri Mar 24 14:21:33 +0000 2017,"Model 3 is just a smaller, more affordable version of Model S w less range &amp; power &amp; fewer features. Model S has more advanced technology.",9414,1707,11121,2017-03-24
3105,845278449811939328,Fri Mar 24 14:17:41 +0000 2017,"Am noticing that many people think Model 3 is the ""next version"" of a Tesla, like iPhone 2 vs 3. This is not true.",7846,1405,9251,2017-03-24
3106,845277819282219010,Fri Mar 24 14:15:11 +0000 2017,@macwalterslives Looking forward to playing the game with my kids!,282,20,302,2017-03-24
3107,845215504738402304,Fri Mar 24 10:07:34 +0000 2017,"@aaronpaul_8 I used to be one. You're welcome. Trying my best, at least. Hope it's a bit useful.",1482,143,1625,2017-03-24
3108,845180973394247680,Fri Mar 24 07:50:21 +0000 2017,@nextspaceflight @inversedotcom Just because I'm building a spaceship to get back to my home planet doesn't mean I'm an alien,2445,674,3119,2017-03-24
3109,845179612644618240,Fri Mar 24 07:44:56 +0000 2017,@lennart375 @inversedotcom The number of extinct single planet civilizations probably exceeds live civs by at least… https://t.co/7rZDEpNOks,449,52,501,2017-03-24
3110,845177494575636480,Fri Mar 24 07:36:32 +0000 2017,"@phirate Probably. Either that, simulation, great filter or they are very, very subtle.",283,11,294,2017-03-24
3111,845175921317335041,Fri Mar 24 07:30:16 +0000 2017,@Nites I hope that didn't work,1133,77,1210,2017-03-24
3112,845175729885081601,Fri Mar 24 07:29:31 +0000 2017,@Nites ~spawn npc.alien,1338,149,1487,2017-03-24
3113,845172927892897792,Fri Mar 24 07:18:23 +0000 2017,Where are the #%*&gt; aliens? https://t.co/FDuJIdwgrN,15316,5464,20780,2017-03-24
3114,844970083000578048,Thu Mar 23 17:52:21 +0000 2017,@wouterhuijs Looks like Tues/Wed for 8.1 release,227,33,260,2017-03-23
3115,844668567983312896,Wed Mar 22 21:54:14 +0000 2017,@x17online Except that isn't actually my house ...,446,37,483,2017-03-22
3116,844360899603288064,Wed Mar 22 01:31:40 +0000 2017,"@karaswisher Perhaps there will be some future bill that makes a difference for Mars, but this is not it.",659,154,813,2017-03-22
3117,844360665900838912,Wed Mar 22 01:30:44 +0000 2017,@karaswisher I am not. This bill changes almost nothing about what NASA is doing. Existing programs stay in place a… https://t.co/RXn1LlD6qa,1076,394,1470,2017-03-22
3118,844358371616567296,Wed Mar 22 01:21:37 +0000 2017,RT @ryanrossuk: @elonmusk Hope you like my Model X customer story. You're something of a hero of mine. Never give up and thank you! https:/…,0,303,303,2017-03-22
3119,843504884154417153,Sun Mar 19 16:50:10 +0000 2017,RT @SpaceX: Recovery teams en route to Dragon. https://t.co/5aiGcX0vS2,0,3564,3564,2017-03-19
3120,842447592172675072,Thu Mar 16 18:48:52 +0000 2017,RT @SpaceX: More photos from today's Falcon 9 launch → https://t.co/095WHWMtKp https://t.co/O2RkVlZnak,0,5060,5060,2017-03-16
3121,842400698025172992,Thu Mar 16 15:42:32 +0000 2017,RT @SpaceX: Successful deployment of @EchoStar XXIII to a Geosynchronous Transfer Orbit confirmed. https://t.co/LpPWLo8YMN,0,2299,2299,2017-03-16
3122,842400673043898368,Thu Mar 16 15:42:26 +0000 2017,RT @SpaceX: Back live for final burn and satellite deployment → https://t.co/gtC39uBC7z https://t.co/8FtMsb9ITp,0,664,664,2017-03-16
3123,842392886494683136,Thu Mar 16 15:11:29 +0000 2017,RT @SpaceX: Liftoff! https://t.co/gtC39uBC7z https://t.co/serafPcpy2,0,2562,2562,2017-03-16
3124,842233727115702272,Thu Mar 16 04:39:03 +0000 2017,"@CapnJesus @Lurpatron @MKBHD @jakerawr 3 is a great car, but definitely Model S",310,18,328,2017-03-16
3125,841565055552389120,Tue Mar 14 08:21:59 +0000 2017,@kyleugh Good point,271,9,280,2017-03-14
3126,841564430399807489,Tue Mar 14 08:19:30 +0000 2017,@PriyancaFord I wish. It's so annoying.,682,33,715,2017-03-14
3127,841563925707546626,Tue Mar 14 08:17:30 +0000 2017,"Finally, an explanation for daylight savings that makes sense ... https://t.co/kGpJHNgRJO",15780,4961,20741,2017-03-14
3128,841098180573851648,Mon Mar 13 01:26:47 +0000 2017,@AndreElijah Ok,713,92,805,2017-03-13
3129,841041891747545089,Sun Mar 12 21:43:07 +0000 2017,"@BizbuilderUSA @mcannonbrookes It's been a bear to get done, but prob 10 days or so, depending on full speed autosteer test results",365,28,393,2017-03-12
3130,841041532140445696,Sun Mar 12 21:41:41 +0000 2017,"@Legit_bacon @mcannonbrookes Looking forward to it. I know it's cliche, but LotR is my favorite book ever :) Want t… https://t.co/uchiQ8P3yb",736,73,809,2017-03-12
3131,841041070792228864,Sun Mar 12 21:39:51 +0000 2017,@5AllanLeVito @mcannonbrookes @VGroysman Sure. Just check out my prior tweet on pricing ($250 kWh at pack level). W… https://t.co/eJ1uXKHrpR,760,229,989,2017-03-12
3132,841040566867509248,Sun Mar 12 21:37:51 +0000 2017,".@mcannonbrookes Can only happen with your support, and working closely with key govt and utility leaders who are s… https://t.co/AlfAGI0kLB",3778,358,4136,2017-03-12
3133,841039231694786560,Sun Mar 12 21:32:33 +0000 2017,"Just wanted to write a note of appreciation to the many Australians who came out in support of the battery plan, especially @mcannonbrookes",11485,1625,13110,2017-03-12
3134,841011061935362048,Sun Mar 12 19:40:37 +0000 2017,@ah_pton16 I love Wikipedia. Just gets better over time.,605,65,670,2017-03-12
3135,840780746868441088,Sun Mar 12 04:25:25 +0000 2017,@JMMZHerrera Answer is complex for electric motors. We use an AC induction motor fed by a DC pack thru an IGBT inve… https://t.co/uKsjIDZPAq,651,73,724,2017-03-12
3136,840774191049658372,Sun Mar 12 03:59:22 +0000 2017,@williamwinters High voltage DC is for sure the best way to transmit electricity over long distances. Good explanat… https://t.co/Ucz8O3Tfm1,797,139,936,2017-03-12
3137,840772319526113280,Sun Mar 12 03:51:56 +0000 2017,"Ironically, direct current is the right approach today, even though alternating was right in the past. Solar power &amp; electronics both DC.",7551,1800,9351,2017-03-12
3138,840770270776315904,Sun Mar 12 03:43:47 +0000 2017,You're most welcome. Very exciting to discuss the future of electricity. Renewables + storage arguably biggest disr… https://t.co/czUfwZkgJE,10577,2519,13096,2017-03-12
3139,840410357122314240,Sat Mar 11 03:53:37 +0000 2017,"@mcannonbrookes Just spoke with @JayWeatherill, Premier of South Australia. Very impressed. Govt is clearly committ… https://t.co/JNOCwKVMxY",3737,1406,5143,2017-03-11
3140,840101692087582720,Fri Mar 10 07:27:06 +0000 2017,"@shails Yes, but shipping, taxes/tariffs and installation labor vary by country, as those costs are beyond our control",917,112,1029,2017-03-10
3141,840096176678420481,Fri Mar 10 07:05:11 +0000 2017,@mcannonbrookes $250/kWh at the pack level for 100MWh+ systems. Tesla is moving to fixed and open pricing and terms for all products.,2008,492,2500,2017-03-10
3142,840032197637685249,Fri Mar 10 02:50:57 +0000 2017,@mcannonbrookes Tesla will get the system installed and working 100 days from contract signature or it is free. That serious enough for you?,16158,6741,22899,2017-03-10
3143,838569247555014656,Mon Mar 06 01:57:43 +0000 2017,@Zedd Will send you one,1273,64,1337,2017-03-06
3144,838565081306677249,Mon Mar 06 01:41:09 +0000 2017,@SimonaKitzu Self-hatred,4590,1361,5951,2017-03-06
3145,838563502386118656,Mon Mar 06 01:34:53 +0000 2017,Thanks JJ!,2313,172,2485,2017-03-06
3146,838558471972741120,Mon Mar 06 01:14:54 +0000 2017,https://t.co/3YSXZq1EVj,24229,3784,28013,2017-03-06
3147,838555180656295936,Mon Mar 06 01:01:49 +0000 2017,RT @TeslaMotors: Project Loveday https://t.co/K1snXJN15u,0,1768,1768,2017-03-06
3148,837113202030759937,Thu Mar 02 01:31:54 +0000 2017,Thank you for the lovely letter. That sounds like a great idea. We'll do it! https://t.co/ss2WmkOGyk,38762,9107,47869,2017-03-02
3149,836443541001797632,Tue Feb 28 05:10:55 +0000 2017,SpaceX could not do this without NASA. Can't express enough appreciation. https://t.co/uQpI60zAV7,25829,4457,30286,2017-02-28
3150,836442868180905984,Tue Feb 28 05:08:14 +0000 2017,"@jamesatbuzz This is not true. TM works for a lot of people and that's great, but I've maybe done it 7 or 8 times ever.",431,26,457,2017-02-28
3151,836328719165763584,Mon Feb 27 21:34:39 +0000 2017,"Fly me to the moon ... Ok
https://t.co/6QT8m5SHwn",54592,29386,83978,2017-02-27
3152,836020571490021376,Mon Feb 27 01:10:11 +0000 2017,SpaceX announcement tomorrow at 1pm PST,26200,6225,32425,2017-02-27
3153,835361919775100929,Sat Feb 25 05:32:56 +0000 2017,@MacTechGenius of course,964,46,1010,2017-02-25
3154,835351081945350145,Sat Feb 25 04:49:52 +0000 2017,@DueDiamond maybe one of those too,615,15,630,2017-02-25
3155,835350234049863680,Sat Feb 25 04:46:30 +0000 2017,Roller coasters are awesome,32322,6978,39300,2017-02-25
3156,835202594968477696,Fri Feb 24 18:59:50 +0000 2017,@johnpaulbrewer Something on a tristate border might work. Gigafactory plus nearby supporting supply chain needs a very large workforce.,482,48,530,2017-02-24
3157,835187859158020097,Fri Feb 24 18:01:17 +0000 2017,@donbarbieri @GreenCarReports Good chance it will,326,21,347,2017-02-24
3158,835187686151315456,Fri Feb 24 18:00:36 +0000 2017,@davidshepardson @BW @ATT @ToysRUs Exactly :),265,11,276,2017-02-24
3159,835185478512992256,Fri Feb 24 17:51:49 +0000 2017,@meganmurp @ChrisFaile @BW I didn't pose for it (hopefully that's obvious) or want me on cover. Tunnel boring machine pic wd be way better,255,15,270,2017-02-24
3160,835178020604301313,Fri Feb 24 17:22:11 +0000 2017,@adrianvolts Minor improvements update this weekend. High speed autosteer in about two weeks.,283,21,304,2017-02-24
3161,834740218531962881,Thu Feb 23 12:22:31 +0000 2017,Excellent Tesla Model X review https://t.co/wvog4Pbo1o,3939,891,4830,2017-02-23
3162,833411017065394176,Sun Feb 19 20:20:45 +0000 2017,Just posted a video https://t.co/RCV7MVi8rs,16690,7307,23997,2017-02-19
3163,833332384913252352,Sun Feb 19 15:08:17 +0000 2017,https://t.co/6Ve3YJoStm,104111,27725,131836,2017-02-19
3164,833332058453790720,Sun Feb 19 15:06:59 +0000 2017,Baby came back https://t.co/5FRhw3AT2b,16519,3732,20251,2017-02-19
3165,833330869293035520,Sun Feb 19 15:02:16 +0000 2017,RT @SpaceX: Falcon 9 first stage has landed at LZ-1,0,5355,5355,2017-02-19
3166,833329896168370179,Sun Feb 19 14:58:24 +0000 2017,@mattnewby no,380,26,406,2017-02-19
3167,833329764232372224,Sun Feb 19 14:57:52 +0000 2017,"RT @NASA: Right on schedule, solar arrays have been deployed on @SpaceX #Dragon cargo spacecraft. Watch: https://t.co/mzKW5uDsTi https://t.…",0,3437,3437,2017-02-19
3168,832995083519614976,Sat Feb 18 16:47:58 +0000 2017,@Xuan_Thai System was green for launch. I called it off.,1082,176,1258,2017-02-18
3169,832992529872097280,Sat Feb 18 16:37:50 +0000 2017,"@spacecom They are often right, but, in this case, we have already retired so much R&amp;D risk on Dragon 2, that I feel very confident of 2018.",541,58,599,2017-02-18
3170,832986598627106818,Sat Feb 18 16:14:15 +0000 2017,"@zperrin99 Uses high pressure bleed off the fuel side (RP-1 kerosene) turbopump, so no dedicated pump or fluid needed",464,38,502,2017-02-18
3171,832984361989386240,Sat Feb 18 16:05:22 +0000 2017,"Btw, 99% likely to be fine (closed loop TVC wd overcome error), but that 1% chance isn't worth rolling the dice. Better to wait a day.",8203,1155,9358,2017-02-18
3172,832979955092819968,Sat Feb 18 15:47:51 +0000 2017,"@Zybbby Not obviously related to the (very tiny) helium leak, but also not out of the question",373,35,408,2017-02-18
3173,832973218348625920,Sat Feb 18 15:21:05 +0000 2017,"If this is the only issue, flight would be fine, but need to make sure that it isn't symptomatic of a more significant upstream root cause",5369,821,6190,2017-02-18
3174,832970849791537152,Sat Feb 18 15:11:41 +0000 2017,"All systems go, except the movement trace of an upper stage engine steering hydraulic piston was slightly odd. Standing down to investigate.",8567,1687,10254,2017-02-18
3175,832954058730115074,Sat Feb 18 14:04:57 +0000 2017,"RT @SpaceX: 1 hour from launch of Falcon 9 &amp; Dragon to @Space_Station. Rocket &amp; weather are go. Launch at 10:01am ET, 15:01 UTC https://t.c…",0,3089,3089,2017-02-18
3176,832871068066942976,Sat Feb 18 08:35:11 +0000 2017,Counting down to the first SpaceX launch from the Apollo 11 launch pad tomorrow morning (webcast… https://t.co/upjTcmftte,6843,1368,8211,2017-02-18
3177,832869029580664833,Sat Feb 18 08:27:05 +0000 2017,RT @NASA: Hear from experts at 5pm ET about the status of tomorrow's 10:01am ET @SpaceX cargo launch to @Space_Station: https://t.co/oJKHgK…,0,971,971,2017-02-18
3178,832868838479851521,Sat Feb 18 08:26:19 +0000 2017,spacex's photo https://t.co/ImEDAut3nI,2588,416,3004,2017-02-18
3179,832863988836814848,Sat Feb 18 08:07:03 +0000 2017,"Provided Dragon 2 demo missions go well, SpaceX is highly confident of being able to fly US astronauts in 2018 https://t.co/usUto6QSi7",5391,1376,6767,2017-02-18
3180,832788691588296705,Sat Feb 18 03:07:51 +0000 2017,Looks like we are go for launch. Added an abort trigger at T-60 secs for pressure decay of upper stage helium spin start system.,6670,1078,7748,2017-02-18
3181,832647116816150530,Fri Feb 17 17:45:17 +0000 2017,"Investigating a (very small) leak in the upper stage. If ok, will launch tomorrow. https://t.co/bQf97lywn4",7410,1651,9061,2017-02-17
3182,832619549937668096,Fri Feb 17 15:55:44 +0000 2017,"@emenietti @chafkin Yes, but only deep in solid rock, where the walls are self-supporting and concrete reinforcements arguably aren't needed",245,11,256,2017-02-17
3183,832480331496185857,Fri Feb 17 06:42:32 +0000 2017,@sc00bs It's much easier to do the CGI that way,2644,599,3243,2017-02-17
3184,832375525754626048,Thu Feb 16 23:46:04 +0000 2017,Daylight rocket launch &amp; landing at the Cape this weekend. Will be the 1st SpaceX flight from the Apollo launch pad. https://t.co/Vr5LQjYaPZ,10580,3135,13715,2017-02-16
3185,832089102266687488,Thu Feb 16 04:47:56 +0000 2017,@PhoebeColeman I used that one :),607,18,625,2017-02-16
3186,832086901704126464,Thu Feb 16 04:39:11 +0000 2017,"Ok, what are some good ones? Will have to meter these out. Hopefully, kids can't die from groaning too much.",6287,501,6788,2017-02-16
3187,832086234302341120,Thu Feb 16 04:36:32 +0000 2017,@VRGTech @Floydilicious They are doing India proud,1208,479,1687,2017-02-16
3188,832085891715723264,Thu Feb 16 04:35:10 +0000 2017,@osiris26 You may come to regret that request :),443,16,459,2017-02-16
3189,832085554619572225,Thu Feb 16 04:33:50 +0000 2017,"@LittleDovah Yeah, exactly. So that makes it cool, right!?",414,7,421,2017-02-16
3190,832084918645596166,Thu Feb 16 04:31:18 +0000 2017,"@Floydilicious Yeah, awesome achievement by ISRO. Very impressive!",2201,1341,3542,2017-02-16
3191,832084402473627650,Thu Feb 16 04:29:15 +0000 2017,"Apparently, there is this thing called ""Dad jokes"" and I make them",25643,4951,30594,2017-02-16
3192,832082377920778240,Thu Feb 16 04:21:12 +0000 2017,"@LudwigMorelos You're right, I can't hide any more! I am Irony Man...",880,116,996,2017-02-16
3193,831972894355828736,Wed Feb 15 21:06:09 +0000 2017,@Samcornwell they were earlier drafts that I accidentally published. I said the same thing a week already.,472,42,514,2017-02-15
3194,831972613912080384,Wed Feb 15 21:05:03 +0000 2017,"In appreciation, Tesla is providing all repair costs free of charge and expedited. https://t.co/D68HNJcCoQ",51724,15420,67144,2017-02-15
3195,831969536584806400,Wed Feb 15 20:52:49 +0000 2017,Congrats to the Tesla owner who sacrificed damage to his own car to bring a car with an unconscious driver safely to a stop!,38341,8195,46536,2017-02-15
3196,831692803210096641,Wed Feb 15 02:33:11 +0000 2017,@lollieshopMOM Best place to watch is on the Cape causeway,304,25,329,2017-02-15
3197,830239445433544704,Sat Feb 11 02:18:03 +0000 2017,@SEACityLight @Nas2four Sounds like the Tesla Powerwall (consumer) and Powerpack (utility/commercial) might be useful,774,91,865,2017-02-11
3198,830148763578662916,Fri Feb 10 20:17:43 +0000 2017,Falcon 9 rocket now vertical at Cape Canaveral on launch complex 39-A. This is the same launch… https://t.co/wY6dWRcer3,9904,2157,12061,2017-02-10
3199,829885356531032064,Fri Feb 10 02:51:02 +0000 2017,@accohen @MeganGeuss @arstechnica Exactly. What this person said is untrue.,331,31,362,2017-02-10
3200,829861775357071361,Fri Feb 10 01:17:19 +0000 2017,"@RusulAlrubail @MarkRuffalo @guardian Please check your facts. Tesla and SpaceX joined as soon as we received the filing, which was Monday.",417,37,454,2017-02-10
3201,829834118733062144,Thu Feb 09 23:27:26 +0000 2017,RT @TeslaMotors: Supercharger availability is now displayed on your Tesla touchscreen so you can see how many stalls are open before you ar…,0,1550,1550,2017-02-09
3202,829509777218613248,Thu Feb 09 01:58:37 +0000 2017,@dknisely of course it will,240,11,251,2017-02-09
3203,829447188325412866,Wed Feb 08 21:49:54 +0000 2017,@SundalJ Should all be uploaded by next month,273,16,289,2017-02-08
3204,829442592978792448,Wed Feb 08 21:31:39 +0000 2017,@sureal808 Motor Trend could only achieve 2.4 sec when they tested the Porsche 918,331,27,358,2017-02-08
3205,829441987686182912,Wed Feb 08 21:29:14 +0000 2017,@VoltzCoreAudio I don't know what make you think that's a rocket. It's completely covered in a tarpaulin...,802,99,901,2017-02-08
3206,829431667072733185,Wed Feb 08 20:48:14 +0000 2017,RT @SpaceX: Targeting Feb. 18 for Dragon's next resupply mission to the @Space_Station — our 1st launch from LC-39A at @NASA's Kennedy Spac…,0,2006,2006,2017-02-08
3207,829396254920568832,Wed Feb 08 18:27:31 +0000 2017,George Schultz and Jim Baker article in @WSJ regarding a carbon tax https://t.co/tf2Urgms85,3488,1453,4941,2017-02-08
3208,829046669517860869,Tue Feb 07 19:18:23 +0000 2017,@BatlaG yes,215,12,227,2017-02-07
3209,829027848434257924,Tue Feb 07 18:03:36 +0000 2017,@goel_ishan Hoping for summer this year,981,370,1351,2017-02-07
3210,829015254524792832,Tue Feb 07 17:13:33 +0000 2017,"@mdcdave yes, altitude improves performance for electric. Opposite of combustion cars.",387,52,439,2017-02-07
3211,829002643947167744,Tue Feb 07 16:23:27 +0000 2017,"@jovanik21 @Veidit No, will be lower. Wheelbase can't fit 100.",287,25,312,2017-02-07
3212,828999653886550018,Tue Feb 07 16:11:34 +0000 2017,"@jovanik21 Also, Tesla service can remove front trunk liner if you don't use it and improve performance further",400,29,429,2017-02-07
3213,828998837578526723,Tue Feb 07 16:08:19 +0000 2017,"@Veidit No plans to take X, S (or 3) above 100 kWh. Semi necessarily and pickup truck maybe will go above.",355,59,414,2017-02-07
3214,828984746029912064,Tue Feb 07 15:12:19 +0000 2017,@jovanik21 Take out the floor mats and its 2.27. MT said everything had to be standard production.,617,42,659,2017-02-07
3215,828983364543664128,Tue Feb 07 15:06:50 +0000 2017,@quick_pi yes,151,7,158,2017-02-07
3216,828981873086865410,Tue Feb 07 15:00:54 +0000 2017,Production Tesla Model S P100DL sets Motor Trend all-time world record to 60 mph in 2.27 sec https://t.co/sxALQrM5Ls,20737,7788,28525,2017-02-07
3217,828840823093497856,Tue Feb 07 05:40:26 +0000 2017,RT @verge: Millions of Tesla battery cells are powering thousands of LA homes https://t.co/NjfzEzAfbv https://t.co/oDGIAkCjiV,0,1474,1474,2017-02-07
3218,828320620463140865,Sun Feb 05 19:13:20 +0000 2017,Signing off now. That was more than enough Twitter trouble for one morning!,7061,359,7420,2017-02-05
3219,828317118051520514,Sun Feb 05 18:59:24 +0000 2017,RT @SteveCase: I agree: https://t.co/mimefUL5ho https://t.co/PKfAyB1QTx,0,459,459,2017-02-05
3220,828315290782093312,Sun Feb 05 18:52:09 +0000 2017,@qriosity_ @MacTechGenius No rare earth metals in battery,686,72,758,2017-02-05
3221,828314791819218944,Sun Feb 05 18:50:10 +0000 2017,@camdtor @trylks Almost ready,579,20,599,2017-02-05
3222,828314321679704066,Sun Feb 05 18:48:18 +0000 2017,@MacTechGenius App update is about two weeks out. Linux kernel and browser update probably a month or so. HW2 Autopilot has priority.,420,37,457,2017-02-05
3223,828312660299091968,Sun Feb 05 18:41:42 +0000 2017,"@FredericLambert Yes, but Model 3 is the overwhelming priority",591,38,629,2017-02-05
3224,828312511946567680,Sun Feb 05 18:41:06 +0000 2017,@clay_ellis I will post an article he wrote half a century ago about flying through Africa and Asia in his plane. One of my favorite things.,706,28,734,2017-02-05
3225,828309896122789889,Sun Feb 05 18:30:43 +0000 2017,@christesla @FredericLambert Almost there. We are just being very careful with the rollout.,403,14,417,2017-02-05
3226,828307625632813056,Sun Feb 05 18:21:41 +0000 2017,@trylks A lot of terrible things could happen in four years of extremism. Do you really want another war? That's where extremism leads.,2450,309,2759,2017-02-05
3227,828305244891336706,Sun Feb 05 18:12:14 +0000 2017,"@FredericLambert Yeah, it is hard to convey complex ideas in 140 chars and tone is lost in text",603,32,635,2017-02-05
3228,828304178644656129,Sun Feb 05 18:07:59 +0000 2017,@CycleTrades @rtoro20 People should push to have as many moderates advising the President as possible. Blind hate is never the right answer.,1676,295,1971,2017-02-05
