,id,Tweet_Date,Tweet_Text,Favorite_Count,Retweet_Count,Popular_Sum,Date
2,1057688156315693057,Wed Oct 31 17:38:02 +0000 2018,@rarelyserious @Tesla Cool haha,6717,259,6976,2018-10-31
5,1057010155332628481,Mon Oct 29 20:43:53 +0000 2018,Deleted my Tesla titles last week to see what would happen. I‚Äôm now the Nothing of Tesla. Seems fine so far.,133112,10056,143168,2018-10-29
32,1055990004738977793,Sat Oct 27 01:10:11 +0000 2018,"On Twitter, likes are rare &amp; criticism is brutal. So hardcore. It‚Äôs great.",170785,16501,187286,2018-10-27
45,1055689369535692801,Fri Oct 26 05:15:34 +0000 2018,I said dankest not darkest omg,135620,12936,148556,2018-10-26
71,1055349794221117440,Thu Oct 25 06:46:13 +0000 2018,How‚Äôd they know!? https://t.co/AZh4EOrgmc,385992,86825,472817,2018-10-25
82,1054601360530784258,Tue Oct 23 05:12:12 +0000 2018,Twitter thought I got hacked &amp; locked my account haha,224586,20857,245443,2018-10-23
86,1054501056229588992,Mon Oct 22 22:33:38 +0000 2018,iüñ§anime,471052,155129,626181,2018-10-22
102,1054115562769416192,Sun Oct 21 21:01:49 +0000 2018,Twitter is Dark Souls of social media. Reddit is Bloodborne. Insta is Zelda.,243665,53178,296843,2018-10-21
116,1053469867452452864,Sat Oct 20 02:16:03 +0000 2018,@FortniteGame Reality is hard,65595,7999,73594,2018-10-20
121,1053390822991790083,Fri Oct 19 21:01:57 +0000 2018,Had to been done ur welcome https://t.co/7jT0f9lqIS,1210847,399819,1610666,2018-10-19
137,1052787992060936193,Thu Oct 18 05:06:31 +0000 2018,Tomorrow brings a lemur https://t.co/rm6S17h35q,62249,5667,67916,2018-10-18
144,1052356093534302208,Wed Oct 17 00:30:19 +0000 2018,Just reviewed Tesla‚Äôs service locations in North America &amp; realized we have major gaps in geographic coverage! Sorr‚Ä¶ https://t.co/bIIdoCjmdu,42014,2740,44754,2018-10-17
145,1052315244716941313,Tue Oct 16 21:48:00 +0000 2018,Insightful article by David @Pogue https://t.co/yo9sPUtM8I,15670,2260,17930,2018-10-16
159,1051714470601342981,Mon Oct 15 06:00:44 +0000 2018,@TTfue Yes,76145,5222,81367,2018-10-15
161,1051389235406598144,Sun Oct 14 08:28:22 +0000 2018,It is time to create a mecha,251858,63474,315332,2018-10-14
172,1051219865661403136,Sat Oct 13 21:15:21 +0000 2018,@yousuck2020 Maybe wise to bring it just in case üëΩüëæ üòâ,19842,839,20681,2018-10-13
176,1050809258659344384,Fri Oct 12 18:03:45 +0000 2018,"Tesla exists to help reduce risk of catastrophic climate change, which affects all species on Earth. Even if your f‚Ä¶ https://t.co/Y28vuHjeaG",179103,29223,208326,2018-10-12
183,1050529142565941248,Thu Oct 11 23:30:40 +0000 2018,"@TeslaNY @InsideEVs @Tesla Exactly. A Tesla is objectively much safer in a crash than all other cars, according to‚Ä¶ https://t.co/A3a9wKo3CV",7589,590,8179,2018-10-11
184,1050164164805545984,Wed Oct 10 23:20:22 +0000 2018,@FinancialTimes This is incorrect,40563,2611,43174,2018-10-10
193,1049679307839131648,Tue Oct 09 15:13:43 +0000 2018,A reminder of why it‚Äôs important to accelerate advent of cars powered by electricity made from solar power https://t.co/sbjSZOeF4c,29307,6424,35731,2018-10-09
206,1049156232030736385,Mon Oct 08 04:35:12 +0000 2018,Falcon has landed https://t.co/joqphUs1AO,191167,25715,216882,2018-10-08
208,1049045561792294912,Sun Oct 07 21:15:26 +0000 2018,"Tesla owner shows how well ultrawhite seats hold up after 25,000 miles. The black &amp; white interior is def best imo. https://t.co/vWQ8X8JHYF",11095,720,11815,2018-10-07
215,1048697377916243969,Sat Oct 06 22:11:53 +0000 2018,"Sonic boom warning. This won‚Äôt be subtle.
https://t.co/WY7dn6BBY1",18374,2585,20959,2018-10-06
230,1048114562694696966,Fri Oct 05 07:35:59 +0000 2018,Tesla owners can refer someone to buy a Tesla &amp; get any image they want laser etched in glass &amp; sent to deep space‚Ä¶ https://t.co/qTEyCAkgJA,27199,3641,30840,2018-10-05
250,1047965410392297472,Thu Oct 04 21:43:18 +0000 2018,People sometimes forget that a company is just a group of people gathered together to make products. So long as it‚Ä¶ https://t.co/EFFQFBxdAy,71338,9697,81035,2018-10-04
261,1046969213854932992,Tue Oct 02 03:44:46 +0000 2018,@cleantechnica Something especially weird going on with Yahoo news feed on iPhone stocks app. Almost always super n‚Ä¶ https://t.co/U6akeEhfMU,8559,563,9122,2018-10-02
262,1046676717350268928,Mon Oct 01 08:22:30 +0000 2018,"Naughty by Nature üòâ
https://t.co/muZdxJWjyZ",26727,2924,29651,2018-10-01
265,1045828553751711746,Sat Sep 29 00:12:12 +0000 2018,That was intense https://t.co/8308Zfmnoj,42840,3868,46708,2018-09-29
268,1045789091801919488,Fri Sep 28 21:35:23 +0000 2018,And remember ‚Ä¶ https://t.co/UaDUv4OlZf,151723,21039,172762,2018-09-28
271,1045152668581163008,Thu Sep 27 03:26:28 +0000 2018,RT @geekwire: Japan‚Äôs ispace strikes deal with SpaceX for launches to the moon in 2020 and 2021 https://t.co/gTwpJqtbxg,0,1664,1664,2018-09-27
272,1045016610006654976,Wed Sep 26 18:25:49 +0000 2018,@scottwww @Tesla Pace of innovation is all that matters in the long run,12591,1213,13804,2018-09-26
276,1044688678042271744,Tue Sep 25 20:42:44 +0000 2018,‚ô•Ô∏è Tesla Owners ‚ô•Ô∏è https://t.co/YbzovKbfgj,61892,3289,65181,2018-09-25
280,1044123822956306432,Mon Sep 24 07:18:12 +0000 2018,@slashdot Tricky one,3943,167,4110,2018-09-24
281,1043293219205787648,Sat Sep 22 00:17:41 +0000 2018,"@DMC_Ryan Wow, thanks for offering to help! The coming week is incredibly intense. If any current Tesla owners who‚Äô‚Ä¶ https://t.co/xxykP10x6l",2900,364,3264,2018-09-22
283,1043250540379926528,Fri Sep 21 21:28:06 +0000 2018,Mars Base Alpha https://t.co/O1llQp8rFY,247680,40249,287929,2018-09-21
296,1042827334758260736,Thu Sep 20 17:26:26 +0000 2018,.@NHTSAgov will post final safety probability stats soon. Model 3 has a shot at being safest car ever tested.,19977,1774,21751,2018-09-20
302,1042530259734683648,Wed Sep 19 21:45:57 +0000 2018,‚ô•Ô∏è @neiltyson,28699,2841,31540,2018-09-19
316,1042117285568073728,Tue Sep 18 18:24:57 +0000 2018,"Moon mission will be livestreamed in high def VR, so it‚Äôll feel like you‚Äôre there in real-time minus a few seconds for speed of light",164071,24585,188656,2018-09-18
348,1041555319166447616,Mon Sep 17 05:11:53 +0000 2018,#OccupyMars,90840,17519,108359,2018-09-17
362,1041421552300916736,Sun Sep 16 20:20:21 +0000 2018,"Tesla is bringing most collision repairs in-house, as outside firms take weeks to months for repairs, driving Tesla owners (and us) crazy",23545,1578,25123,2018-09-16
364,1041108570740158464,Sat Sep 15 23:36:40 +0000 2018,"Tesla owners can grant free Supercharging for life to a friend who buys S/3/X. Ends tomorrow night. https://t.co/7ZDXeIQVc7""",19936,2479,22415,2018-09-15
372,1040486759820218368,Fri Sep 14 06:25:49 +0000 2018,Electric cars made with sunlight https://t.co/utVdn9mSmy,63892,7487,71379,2018-09-14
377,1040142708453457926,Thu Sep 13 07:38:41 +0000 2018,Bricks will be free if used for affordable housing projects,21645,1804,23449,2018-09-13
383,1039982911322087429,Wed Sep 12 21:03:42 +0000 2018,"Due to a large increase in vehicle delivery volume in North America, Tesla customers may experience longer response‚Ä¶ https://t.co/2L1xx0mADc",33063,1776,34839,2018-09-12
387,1039437131976867840,Tue Sep 11 08:54:58 +0000 2018,@adultswim @RickandMorty Best show in the multiverse!,42583,4189,46772,2018-09-11
393,1039024232208859136,Mon Sep 10 05:34:15 +0000 2018,RT @SpaceX: Successful deployment of Telstar 18 VANTAGE to a geostationary transfer orbit confirmed. https://t.co/nlRgxoILJ9,0,1964,1964,2018-09-10
394,1038911263143682049,Sun Sep 09 22:05:21 +0000 2018,RT @jack: This is an honest and fun conversation between @elonmusk and @joerogan. Stop at the headlines and memes and you‚Äôll miss all the t‚Ä¶,0,4692,4692,2018-09-09
397,1038537654827024384,Sat Sep 08 21:20:46 +0000 2018,"Not easy coming up with a good cover story for an underground volcano lair, but I think it‚Äôs working",96116,8923,105039,2018-09-08
405,1037973950150541312,Fri Sep 07 08:00:48 +0000 2018,"Good times with @JoeRogan ‚Ä¶
https://t.co/8uZUsEJoq1",59799,8695,68494,2018-09-07
407,1037502853680517120,Thu Sep 06 00:48:50 +0000 2018,"Tesla 1st, 2nd &amp; 3rd in August sales https://t.co/npDKC9QEpP",14243,1540,15783,2018-09-06
409,1037249325464600578,Wed Sep 05 08:01:25 +0000 2018,Will be on @JoeRogan at 9:30pm Pacific on Thursday,107712,18148,125860,2018-09-05
411,1036742121271779328,Mon Sep 03 22:25:58 +0000 2018,"@mliebow @Tesla Much appreciated! Great word-of-mouth is why Model 3 is the best-selling electric car, despite no a‚Ä¶ https://t.co/c0chjdggPv",13868,808,14676,2018-09-03
416,1035320831725920256,Fri Aug 31 00:18:16 +0000 2018,@CNN Can Steve Bannon please insult me some more? Best PR I‚Äôve had in a while.,56755,4644,61399,2018-08-31
418,1035029257557237760,Thu Aug 30 04:59:39 +0000 2018,@ElectrekCo @FredericLambert !,8392,431,8823,2018-08-30
419,1034654594670841856,Wed Aug 29 04:10:52 +0000 2018,@GlamandGore I was told that his parents preferred that his name not be mentioned,6981,143,7124,2018-08-29
428,1034458577346260992,Tue Aug 28 15:11:58 +0000 2018,"@TijenOnaran For the record, my voice cracked once during the NY Times article. That‚Äôs it. There were no tears.",16308,967,17275,2018-08-28
430,1034211853646221312,Mon Aug 27 22:51:35 +0000 2018,@jwiechers @SwiftOnSecurity I want that outfit,593,17,610,2018-08-27
431,1033543361787977728,Sun Aug 26 02:35:14 +0000 2018,"The world lost a great man in John McCain. He was an honorable, kind, brave and fundamentally decent human being. I‚Ä¶ https://t.co/KUnxG1VA4o",93251,9557,102808,2018-08-26
435,1033493134645317633,Sat Aug 25 23:15:39 +0000 2018,@yanquetino @Tesla Most people don‚Äôt realize that the cost of operating an electric vehicle is much lower than a ga‚Ä¶ https://t.co/CwCU40VmPo,40765,5060,45825,2018-08-25
450,1032804122330845184,Fri Aug 24 01:37:45 +0000 2018,"Goal is to service your car wherever you are, quietly &amp; quickly. No need to bring it to a Tesla service center. https://t.co/KCIFtliZr8",47388,5311,52699,2018-08-24
452,1032575096701906944,Thu Aug 23 10:27:42 +0000 2018,"Love born in the brain is more spirited, doubtless, than true love, but it has only flashes of enthusiasm; it knows‚Ä¶ https://t.co/XNTiYEMNmI",37570,5531,43101,2018-08-23
457,1032411200213024769,Wed Aug 22 23:36:26 +0000 2018,@tldtoday @Tesla Thanks for buying our car! Would highly recommend performance version. It‚Äôs really good &amp; I don‚Äôt‚Ä¶ https://t.co/rs1UQ3wLay,10285,349,10634,2018-08-22
460,1032042656040251392,Tue Aug 21 23:11:58 +0000 2018,https://t.co/Q9JE06lmWN,42097,2905,45002,2018-08-21
466,1031684325048168448,Mon Aug 20 23:28:05 +0000 2018,RT @MKBHD: NEW VIDEO - Tesla Factory Tour with Elon Musk! https://t.co/JwlED0vP3s - RT! https://t.co/NEt90rFzbu,0,3711,3711,2018-08-20
468,1031111742103814144,Sun Aug 19 09:32:51 +0000 2018,@ariannahuff Ford &amp; Tesla are the only 2 American car companies to avoid bankruptcy. I just got home from the facto‚Ä¶ https://t.co/KQ1dOYjKlW,43202,3892,47094,2018-08-19
470,1030632127870599168,Sat Aug 18 01:47:02 +0000 2018,Great meeting you! https://t.co/Z16NK3GuXp,83295,6000,89295,2018-08-18
474,1029938219125694464,Thu Aug 16 03:49:41 +0000 2018,Defeating traffic is the ultimate boss battle,101187,13324,114511,2018-08-16
477,1029862136439160832,Wed Aug 15 22:47:21 +0000 2018,RT @SpaceX: Falcon 9 lands on the ‚ÄúOf Course I Still Love You‚Äù droneship and returns to port after delivering the Merah Putih satellite to‚Ä¶,0,3859,3859,2018-08-15
484,1029171381584314368,Tue Aug 14 01:02:33 +0000 2018,"@Tesla I‚Äôm excited to work with Silver Lake and Goldman Sachs as financial advisors, plus Wachtell, Lipton, Rosen &amp;‚Ä¶ https://t.co/MrXU5ULvOu",13228,1325,14553,2018-08-14
486,1029001597982928898,Mon Aug 13 13:47:53 +0000 2018,"@amitkatwala @WiredUK Mostly accurate, even though I didn‚Äôt do an interview (or pose for cover)",9358,444,9802,2018-08-13
489,1028773837557649410,Sun Aug 12 22:42:51 +0000 2018,Model 3 traction testing on pure ice &amp; snow https://t.co/knIg6JMNHO,32499,3323,35822,2018-08-12
502,1028121465785405441,Sat Aug 11 03:30:33 +0000 2018,Short shorts coming soon to Tesla merch,109127,17293,126420,2018-08-11
508,1027782177721790465,Fri Aug 10 05:02:21 +0000 2018,@SpaceXUpdates Those are the new design made of titanium. Doesn‚Äôt need heat shielding or even paint.,4822,226,5048,2018-08-10
509,1027643485241974785,Thu Aug 09 19:51:14 +0000 2018,RT @Model3Owners: Free trial of Autopilot for those who haven‚Äôt purchased it is starting to roll out. 14 days to decide if you want it or n‚Ä¶,0,706,706,2018-08-09
514,1027294935504936960,Wed Aug 08 20:46:13 +0000 2018,Tesla deliveries &amp; AP hardware chart by @lexfridman at MIT https://t.co/6vZxKMcec2,11705,1306,13011,2018-08-08
529,1026872652290379776,Tue Aug 07 16:48:13 +0000 2018,Am considering taking Tesla private at $420. Funding secured.,88738,16354,105092,2018-08-07
535,1026262681848709120,Mon Aug 06 00:24:25 +0000 2018,That‚Äôs right provided the two Crew Dragon test flights go well. Hardware will def be ready. https://t.co/KcAFArYn1x,14315,1675,15990,2018-08-06
555,1026073171638738944,Sun Aug 05 11:51:22 +0000 2018,"Dang, turns out even Hitler was shorting Tesla stock ‚Ä¶ https://t.co/RLM1VQ5O3K",19127,2909,22036,2018-08-05
557,1025788479483961350,Sat Aug 04 17:00:06 +0000 2018,Squirrels ‚Ä¶ https://t.co/sVegPxD046,16948,1378,18326,2018-08-04
559,1025377867532627968,Fri Aug 03 13:48:28 +0000 2018,RT @Tesla: Tesla Grid Controller and Powerpacks optimize renewable energy across Samoa‚Äôs grid https://t.co/yhu738mRt0 https://t.co/w2TpAAaH‚Ä¶,0,1049,1049,2018-08-03
561,1025134835226959872,Thu Aug 02 21:42:45 +0000 2018,RT @Tesla: Gigafactory 1 battery production has reached an annualized run rate of¬†‚âà20 GWh - more kWh than all other carmakers combined http‚Ä¶,0,2652,2652,2018-08-02
567,1024758123406323712,Wed Aug 01 20:45:50 +0000 2018,"If you‚Äôre into video game development, consider applying to Tesla. We want to make super fun games that integrate t‚Ä¶ https://t.co/MZcsHs5D8s",79070,12642,91712,2018-08-01
593,1024137570463051778,Tue Jul 31 03:39:59 +0000 2018,@DiscoverMag There‚Äôs a massive amount of CO2 on Mars adsorbed into soil that‚Äôd be released upon heating. With enoug‚Ä¶ https://t.co/e50VH0IiaP,30239,2639,32878,2018-07-31
596,1023779158030077952,Mon Jul 30 03:55:46 +0000 2018,"We tried out a new delivery system using an enclosed trailer straight from factory to owner‚Äôs home, so super conven‚Ä¶ https://t.co/rZ3r0MSOKh",42479,3685,46164,2018-07-30
605,1023674091142701056,Sun Jul 29 20:58:16 +0000 2018,Nothing is both real &amp; imaginary,52811,10104,62915,2018-07-29
611,1023067599528124416,Sat Jul 28 04:48:18 +0000 2018,üñ§üöÄüí´ https://t.co/HPu4SfoM0P,11586,889,12475,2018-07-28
616,1022879510239170560,Fri Jul 27 16:20:54 +0000 2018,@WhatTheFFacts What‚Äôs technology?,10962,576,11538,2018-07-27
617,1022430321696858113,Thu Jul 26 10:35:59 +0000 2018,"Worth another retweet. Hope Dan Neil returns to Twitter. He left due to relentless attacks from short-sellers, who‚Ä¶ https://t.co/gKb2aU5E43",23583,3003,26586,2018-07-26
626,1022000378462855168,Wed Jul 25 06:07:32 +0000 2018,"M√∂tor Trƒìnd
https://t.co/jilxFHjkYW",14371,1506,15877,2018-07-25
628,1021565852242464769,Tue Jul 24 01:20:53 +0000 2018,"RT @Tesla: 11,353 charging locations across the world and growing daily https://t.co/uNt2wUNT3c",0,1477,1477,2018-07-24
636,1021263722944217093,Mon Jul 23 05:20:20 +0000 2018,Wall Street https://t.co/gvZyxMwO5m,13813,1401,15214,2018-07-23
640,1020835959833677824,Sun Jul 22 01:00:33 +0000 2018,RT @SpaceX: Falcon 9 and Telstar 19 VANTAGE went vertical this afternoon on Pad 40 in Florida. Weather is 60% favorable for the four-hour l‚Ä¶,0,1653,1653,2018-07-22
657,1020491376104898562,Sat Jul 21 02:11:18 +0000 2018,No kidding https://t.co/Vz3FdEO7Ud,25109,3330,28439,2018-07-21
664,1020108713061855233,Fri Jul 20 00:50:44 +0000 2018,"@vincent13031925 @bonnienorman @Jason @scottwww Dunno where this bs is coming from. Who knows about the future, but‚Ä¶ https://t.co/5pu1UQboJc",7360,589,7949,2018-07-20
666,1020067893222858752,Thu Jul 19 22:08:32 +0000 2018,"Thanks Dan, you are a tough reviewer, so this means a lot coming from you. Please lmk even smallest nuance that can‚Ä¶ https://t.co/COHuQVgtco",14723,1010,15733,2018-07-19
672,1019471467304513537,Wed Jul 18 06:38:33 +0000 2018,"@adamchavez As this well-written article suggests, my words were spoken in anger after Mr. Unsworth said several un‚Ä¶ https://t.co/dQyW0yV26v",22059,1933,23992,2018-07-18
675,1019368951782957056,Tue Jul 17 23:51:11 +0000 2018,@lrroberts87 Good point,1459,58,1517,2018-07-17
683,1018330925384458240,Sun Jul 15 03:06:26 +0000 2018,Reports that I am a top donor to GOP are categorically false. I am not a top donor to any political party.,71817,6936,78753,2018-07-15
689,1018265614295523328,Sat Jul 14 22:46:55 +0000 2018,"@jack_p Thanks Jack. To be clear, I am not a conservative. Am registered independent &amp; politically moderate. Doesn‚Äô‚Ä¶ https://t.co/gLNQ9jRgLv",48268,4173,52441,2018-07-14
705,1017700488958144512,Fri Jul 13 09:21:19 +0000 2018,"@Tesla Whether you plan to buy a Dual Motor Performance Model 3 or not, take it for a test drive anyway. It‚Äôs like‚Ä¶ https://t.co/WF5ZRE854J",14514,841,15355,2018-07-13
721,1017333757077008385,Thu Jul 12 09:04:03 +0000 2018,Just finished an amazing 3 day visit to China. The world has never seen human energy &amp; vigor at such scale. Incredi‚Ä¶ https://t.co/pdoSWxgzLa,42800,2931,45731,2018-07-12
738,1017149641991680002,Wed Jul 11 20:52:27 +0000 2018,@DylanSheaMusic Please consider this a commitment that I will fund fixing the water in any house in Flint that has‚Ä¶ https://t.co/UT3wmEE0m8,109695,27987,137682,2018-07-11
760,1016731812159254529,Tue Jul 10 17:12:08 +0000 2018,"@eehouls No, it means I created jobs for 50,000 people directly and, through parts suppliers &amp; supporting professio‚Ä¶ https://t.co/FiVvSb64F6",114044,20444,134488,2018-07-10
769,1016443130017505280,Mon Jul 09 22:05:01 +0000 2018,Just returned from Cave 3. Mini-sub is ready if needed. It is made of rocket parts &amp; named Wild Boar after kids‚Äô so‚Ä¶ https://t.co/mB9p1ZaM9C,303854,84207,388061,2018-07-09
782,1016063173139427329,Sun Jul 08 20:55:12 +0000 2018,https://t.co/D1umiFDr1t,205376,53886,259262,2018-07-08
815,1015507453818044416,Sat Jul 07 08:06:58 +0000 2018,Some good feedback from cave experts in Thailand. Iterating with them on an escape pod design that might be safe en‚Ä¶ https://t.co/5yqKGma8tL,151420,23845,175265,2018-07-07
831,1015138953693880320,Fri Jul 06 07:42:41 +0000 2018,@JamesWorldSpace SpaceX &amp; Boring Co engineers headed to Thailand tomorrow to see if we can be helpful to govt. Ther‚Ä¶ https://t.co/fEMwkYrXCj,21733,7914,29647,2018-07-06
859,1014812681499365376,Thu Jul 05 10:06:12 +0000 2018,"Note, no one is in the car or controlling remotely. Car is driving entirely by itself. https://t.co/xSG2Mmy756",24976,2535,27511,2018-07-05
875,1014509856777293825,Wed Jul 04 14:02:53 +0000 2018,"@MabzMagz I suspect that the Thai govt has this under control, but I‚Äôm happy to help if there is a way to do so",21177,3070,24247,2018-07-04
883,1014248438710636544,Tue Jul 03 20:44:06 +0000 2018,The Spice Flows https://t.co/YMyhVGIxHc,21921,1760,23681,2018-07-03
885,1013897145773166595,Mon Jul 02 21:28:11 +0000 2018,@WillFealey @Tesla @RadioFlyer Sure,8393,266,8659,2018-07-02
887,1013519243030253570,Sun Jul 01 20:26:32 +0000 2018,"7000 cars, 7 days
‚ô•Ô∏è Tesla Team ‚ô•Ô∏è",150961,14124,165085,2018-07-01
888,1012942067365023744,Sat Jun 30 06:13:03 +0000 2018,@santidebus Then what‚Äôs this wand for?,1609,61,1670,2018-06-30
893,1012783222386712576,Fri Jun 29 19:41:51 +0000 2018,Engineering is magic,138387,32062,170449,2018-06-29
922,1012416542724665346,Thu Jun 28 19:24:48 +0000 2018,"Appreciate all the good wishes. First bday I‚Äôve spent in the factory, but it‚Äôs somehow the best.",61986,2933,64919,2018-06-28
941,1011761562523086848,Wed Jun 27 00:02:08 +0000 2018,"@Penenberg For sure! When doing US govt crash safety testing, the Model S roof was so strong, it broke their testin‚Ä¶ https://t.co/XyK9lpSHCf",12274,1722,13996,2018-06-27
946,1011672532838055937,Tue Jun 26 18:08:22 +0000 2018,"What would you love to see in a Tesla pickup truck? I have a few things in mind, but what do you think are small, b‚Ä¶ https://t.co/iTfGbHL4tf",54254,5142,59396,2018-06-26
973,1011083630301536256,Mon Jun 25 03:08:17 +0000 2018,This is why we must preserve the light of consciousness by becoming a spacefaring civilization &amp; extending life to‚Ä¶ https://t.co/BKu7IPETSX,44173,7932,52105,2018-06-25
981,1011021456526987266,Sun Jun 24 23:01:13 +0000 2018,Tesla Semi Truck in Mad Max Mode https://t.co/hL5v9rikhW,50017,6281,56298,2018-06-24
992,1010596809616445440,Sat Jun 23 18:53:50 +0000 2018,Looks so sus when we paint cars red https://t.co/SIO2nInjhJ,82968,8502,91470,2018-06-23
1011,1010223743287771136,Fri Jun 22 18:11:24 +0000 2018,@Model3Owners Was thinking of offering an extended Tesla factory tour option where you could help build part of a c‚Ä¶ https://t.co/H0Qti5bipn,16345,1133,17478,2018-06-22
1027,1009613082770001920,Thu Jun 21 01:44:51 +0000 2018,"Without change, something sleeps inside us, and seldom awakens. The sleeper must awaken. FH ‚Ä¶ https://t.co/FjW31RPSqh",43138,6433,49571,2018-06-21
1038,1009471275113123840,Wed Jun 20 16:21:21 +0000 2018,@adultswim Because honey is a vegetable,7100,546,7646,2018-06-20
1047,1009200969253511168,Tue Jun 19 22:27:15 +0000 2018,Thank you for helping those in need https://t.co/GF7b3y7MLr,21236,1437,22673,2018-06-19
1082,1008858642550943745,Mon Jun 18 23:46:58 +0000 2018,@amendlocke You won‚Äôt find pro-union either. The books are all about freedom. No one is forced to join any organization.,2676,102,2778,2018-06-18
1130,1008170402969841664,Sun Jun 17 02:12:09 +0000 2018,The enemy of my enemy is myself https://t.co/momMBAEuzU,74209,9453,83662,2018-06-17
1149,1008012300979077121,Sat Jun 16 15:43:55 +0000 2018,"‚ÄúNo sense of humor‚Äù is certainly proving itself true. Good grief!
How many socialists does it take to screw in a li‚Ä¶ https://t.co/kAhUtGlkGe",54472,6517,60989,2018-06-16
1162,1007752686878388224,Fri Jun 15 22:32:18 +0000 2018,"Those who proclaim themselves ‚Äúsocialists‚Äù are usually depressing, have no sense of humor &amp; attended an expensive college. Fate loves irony.",179274,44820,224094,2018-06-15
1179,1007076304095625216,Thu Jun 14 01:44:36 +0000 2018,@ralphbakshi Dankonia,11440,1096,12536,2018-06-14
1180,1006968985760366592,Wed Jun 13 18:38:09 +0000 2018,@korihale @Tesla @CultureBanx @Forbes We use less than 3% cobalt in our batteries &amp; will use none in next gen,13610,964,14574,2018-06-13
1184,1006597562156003328,Tue Jun 12 18:02:15 +0000 2018,"Difficult, but necessary Tesla reorg underway. My email to the company has already leaked to media. Here it is unfi‚Ä¶ https://t.co/oP4buaF9ZS",72382,10920,83302,2018-06-12
1186,1006311825833541632,Mon Jun 11 23:06:50 +0000 2018,@mayemusk @kimbal Back in the Precambrian era when the main form of life was a sponge,945,50,995,2018-06-11
1206,1005699514630471680,Sun Jun 10 06:33:43 +0000 2018,This is why I‚Äôm not impressed when reporters who were literally in junior high while I was in newsrooms all round t‚Ä¶ https://t.co/DScG4rWbg6,26314,2444,28758,2018-06-10
1219,1005553979386880000,Sat Jun 09 20:55:25 +0000 2018,Almost forgot! Due to recent regulatory/customs rules enacted to inhibit transport of anything called a Flamethrowe‚Ä¶ https://t.co/Ir6Qnyq1uu,110114,14703,124817,2018-06-09
1233,1004936605797212160,Fri Jun 08 04:02:12 +0000 2018,Running track in @SpaceX BF Spaceship will look something like this https://t.co/563upTfV58,54506,7807,62313,2018-06-08
1240,1004792846182801408,Thu Jun 07 18:30:57 +0000 2018,Tip of the day ‚Ä¶ https://t.co/MjbYlseX45,14556,1090,15646,2018-06-07
1242,1004212406849978368,Wed Jun 06 04:04:29 +0000 2018,@lexiheft @Tesla Coming soon,1132,40,1172,2018-06-06
1244,1004134357420859394,Tue Jun 05 22:54:21 +0000 2018,RT @Tesla: Model 3 is now the best-selling mid-sized premium sedan in the USA https://t.co/xI7LsgRI6D,0,5990,5990,2018-06-05
1250,1003701407004758016,Mon Jun 04 18:13:57 +0000 2018,"@sonic_hedgehog Good morning, Sonic. Not sure how to break it to you, but ‚Ä¶ https://t.co/RPpOchBMKJ",32702,4896,37598,2018-06-04
1254,1003158520919814145,Sun Jun 03 06:16:43 +0000 2018,@cassianelwes Appreciated on behalf of Tesla team,5184,141,5325,2018-06-03
1265,1002980786977402880,Sat Jun 02 18:30:28 +0000 2018,Mason jars with a handle or wine stem cause me to lose faith in humanity,52732,6262,58994,2018-06-02
1285,1002372491514441728,Fri Jun 01 02:13:19 +0000 2018,"Cool, Tesla S/X have hospital operating room air quality when BWD mode is activated, so shd protect against even a‚Ä¶ https://t.co/wY1NYnh3in",49494,6711,56205,2018-06-01
1297,1002041479777406976,Thu May 31 04:18:00 +0000 2018,Hell of a week https://t.co/jKsfykkG55,165160,27196,192356,2018-05-31
1312,1001858830832029696,Wed May 30 16:12:13 +0000 2018,Like you guys too üöò üñ§ https://t.co/PVQVyR1nXY,15427,704,16131,2018-05-30
1320,1001532526878310400,Tue May 29 18:35:36 +0000 2018,"At risk of stating the extremely obvious, I am against threats of violence &amp; abusive epithets in any forum. Please‚Ä¶ https://t.co/dbku2At4zE",61040,4530,65570,2018-05-29
1346,1001240912691789825,Mon May 28 23:16:50 +0000 2018,Thank you for the lovely letter https://t.co/xGNMj5FOhg,9903,595,10498,2018-05-28
1356,1000560049389907969,Sun May 27 02:11:19 +0000 2018,@joshuatopolsky @oneunderscore__ @ParkerMolloy @2sunsky @ashleyfeinberg Who do you think *owns* the press? Hello.,16122,4948,21070,2018-05-27
1405,1000332404618227712,Sat May 26 11:06:45 +0000 2018,Can‚Äôt believe someone leaked this schematic of the Tesla production system!! https://t.co/ylAX3uKTI1,47500,4323,51823,2018-05-26
1423,1000080833678528512,Fri May 25 18:27:06 +0000 2018,"Problem solved, was able to buy https://t.co/ivSUwPqsDT! Game on ‚Ä¶",37834,4407,42241,2018-05-25
1462,999450636075778049,Thu May 24 00:42:55 +0000 2018,"For some reason, this is the best I‚Äôve felt in a while. Hope you‚Äôre feeling good too üöÄ‚ô•Ô∏èüåè",149599,17390,166989,2018-05-24
1484,999367582271422464,Wed May 23 19:12:53 +0000 2018,Going to create a site where the public can rate the core truth of any article &amp; track the credibility score over t‚Ä¶ https://t.co/r30AlZA598,247790,51275,299065,2018-05-23
1521,998786412970369024,Tue May 22 04:43:32 +0000 2018,Just wanted to say thanks to all Tesla supporters. I damn well love you.,149590,9801,159391,2018-05-22
1544,998409778316496896,Mon May 21 03:46:55 +0000 2018,SpaceX Crew Dragon ship in anechoic chamber for EMI testing before being sent to @NASA Plum Brook vacuum chamber https://t.co/BckUBkroLw,28741,3610,32351,2018-05-21
1572,998082149356994560,Sun May 20 06:05:02 +0000 2018,Will soon enable Tesla owners to request service from their phone with a few taps. Tesla Ranger will come to you to‚Ä¶ https://t.co/FkYeHDJpRB,60199,5145,65344,2018-05-20
1578,997943053317849088,Sat May 19 20:52:19 +0000 2018,Working on Model 3 dual motor all-wheel drive &amp; performance versions. Driving feel is amazing. Aiming to release config late tonight.,44265,3923,48188,2018-05-19
1584,997372686182449152,Fri May 18 07:05:53 +0000 2018,üêå,48385,7518,55903,2018-05-18
1588,997005264116105217,Thu May 17 06:45:53 +0000 2018,Listening to REALiTi,33030,5051,38081,2018-05-17
1592,996691566851801088,Wed May 16 09:59:21 +0000 2018,Boring Company Hyperloop will take you from city center under ground &amp; ocean to spaceport in 10 to 15 mins https://t.co/VhpfhgdXSd,23944,2537,26481,2018-05-16
1594,996189963266936832,Tue May 15 00:46:10 +0000 2018,RT @Tesla: 140 Tesla Powerpacks now live in Belgium and balancing the European electrical grid 100 times faster than fossil fuel plants htt‚Ä¶,0,4962,4962,2018-05-15
1598,996131586469842945,Mon May 14 20:54:12 +0000 2018,"It‚Äôs super messed up that a Tesla crash resulting in a broken ankle is front page news and the ~40,000 people who d‚Ä¶ https://t.co/Kr5jG0OYO3",114902,25375,140277,2018-05-14
1608,995461033958424576,Sun May 13 00:29:39 +0000 2018,Good piece by Ars https://t.co/7C3X0TjUX9,10799,1049,11848,2018-05-13
1613,995125446634188800,Sat May 12 02:16:09 +0000 2018,@boringcompany Yo,31063,1742,32805,2018-05-12
1629,994759514082684928,Fri May 11 02:02:04 +0000 2018,First Boring Company tunnel under LA almost done! Pending final‚Ä¶ https://t.co/oWHlwOgCJE,30909,3988,34897,2018-05-11
1641,994381742646554625,Thu May 10 01:00:56 +0000 2018,Tesla quarterly all-hands video. Love the shot of wild horses &amp; Giga in winter https://t.co/ZGZbpSFhus,13757,2204,15961,2018-05-10
1652,994055600232321024,Wed May 09 03:24:58 +0000 2018,"@nypost That‚Äôs a white rose on my jacket &amp; the choker is a bunch of spikes, not Tesla anything",26553,1261,27814,2018-05-09
1655,993995967610290176,Tue May 08 23:28:00 +0000 2018,@WeDragonSlayers Flesh without Blood &amp; Kill V Maim on Art Angels album https://t.co/MycGWvbYGk,5280,1020,6300,2018-05-08
1662,993546386518966275,Mon May 07 17:41:32 +0000 2018,@drmistercody The Boring Company will be using dirt from tunnel digging to create bricks for low cost housing,28415,2783,31198,2018-05-07
1666,992941109222391808,Sun May 06 01:36:23 +0000 2018,I‚Äôm killin me lol,108607,23932,132539,2018-05-06
1675,992876606979952640,Sat May 05 21:20:04 +0000 2018,I‚Äôm starting a candy company &amp; it‚Äôs going to be amazing,255684,42646,298330,2018-05-05
1684,992388944774938626,Fri May 04 13:02:16 +0000 2018,Oh and uh short burn of the century comin soon. Flamethrowers should arrive just in time.,45425,3169,48594,2018-05-04
1698,991944456466202624,Thu May 03 07:36:02 +0000 2018,You‚Äôre most welcome https://t.co/5lOHSWHWhc,10637,635,11272,2018-05-03
1701,991786023351869441,Wed May 02 21:06:29 +0000 2018,"La la la
https://t.co/rLQfmrcNO2",53369,6346,59715,2018-05-02
1705,991130075889205248,Tue May 01 01:39:59 +0000 2018,@Gfilche @Tesla Ok,5354,232,5586,2018-05-01
1707,990854677926297600,Mon Apr 30 07:25:39 +0000 2018,I have prehensile eyebrows,42303,3305,45608,2018-04-30
1709,990028017861705729,Sat Apr 28 00:40:47 +0000 2018,"@Grimezsz Yeah, most people don‚Äôt know this, but comets r mostly made of cocaine",3280,889,4169,2018-04-28
1710,989986716004958208,Fri Apr 27 21:56:40 +0000 2018,@WorldAndScience Almost ready to test the new Boring Company / SpaceX hyperpod prototype. Exciting video guaranteed.,27839,2144,29983,2018-04-27
1712,989362154242428928,Thu Apr 26 04:34:53 +0000 2018,@GameOfThrones Don‚Äôt make me use my space lasers ‚Ä¶,43658,4519,48177,2018-04-26
1714,989198118666162176,Wed Apr 25 17:43:04 +0000 2018,Oh btw I‚Äôm building a cyborg dragon,467845,108242,576087,2018-04-25
1718,988294892219654144,Mon Apr 23 05:53:58 +0000 2018,RT @kanyewest: I really love my Tesla. I'm in the future. Thank you Elon.,0,26988,26988,2018-04-23
1722,986850982138032128,Thu Apr 19 06:16:23 +0000 2018,RT @NASA: How many worlds exist outside our solar system? @NASA_TESS launched from planet Earth today at 6:51pm ET to hunt for planets arou‚Ä¶,0,4558,4558,2018-04-19
1723,986746909153869824,Wed Apr 18 23:22:50 +0000 2018,Tesla batteries are currently live &amp; delivering power at 662 locations in Puerto Rico. Team is working 24/7 to acti‚Ä¶ https://t.co/EVBMrsxu3k,162737,36133,198870,2018-04-18
1732,986322814985584640,Tue Apr 17 19:17:38 +0000 2018,Driving a Model 3 and playing https://t.co/5xa3FUWuXy,15742,1838,17580,2018-04-17
1735,985684755877265408,Mon Apr 16 01:02:13 +0000 2018,And then land on a bouncy house,73025,6776,79801,2018-04-16
1737,985655249745592320,Sun Apr 15 23:04:58 +0000 2018,SpaceX will try to bring rocket upper stage back from orbital velocity using a giant party balloon,105461,14962,120423,2018-04-15
1743,984882630947753984,Fri Apr 13 19:54:52 +0000 2018,"@timkhiggins Yes, excessive automation at Tesla was a mistake. To be precise, my mistake. Humans are underrated.",41434,7909,49343,2018-04-13
1751,984498847232622592,Thu Apr 12 18:29:50 +0000 2018,@TEDTalks @i_firth Norway has some really cool tunnels and bridges,7801,366,8167,2018-04-12
1752,983863209491775488,Wed Apr 11 00:24:03 +0000 2018,@AshleyEsqueda @petesjca @monitron @Tesla Should be fully fixed within the next few days,612,23,635,2018-04-11
1754,983621641262399489,Tue Apr 10 08:24:08 +0000 2018,@PDChina This is a very important action by China. Avoiding a trade war will benefit all countries.,1448,192,1640,2018-04-10
1756,983207596298522626,Mon Apr 09 04:58:52 +0000 2018,SpaceX main body tool for the BFR interplanetary spaceship https://t.co/WbTITI6WSu,20805,3082,23887,2018-04-09
1765,982826517443915776,Sun Apr 08 03:44:36 +0000 2018,Upgraded SpaceX/Tesla Hyperloop pod speed test soon. Will try to reach half speed of sound (and brake) within ~1.2km.,14043,1207,15250,2018-04-08
1768,982716415089299457,Sat Apr 07 20:27:06 +0000 2018,https://t.co/WehHd0eJeO at 5M views after 36 hours. Congrats to Chris Paine &amp; co!,17681,2658,20339,2018-04-07
1772,982119546420002817,Fri Apr 06 04:55:21 +0000 2018,Nothing will affect the future of humanity more than digital super-intelligence. Watch Chris Paine‚Äôs new AI movie f‚Ä¶ https://t.co/0vpd97vKdx,51856,15977,67833,2018-04-06
1773,982017761575518208,Thu Apr 05 22:10:54 +0000 2018,Chris Paine AI movie premiering tonight https://t.co/kXM7USFi8D,14784,2704,17488,2018-04-05
1777,981581215344939008,Wed Apr 04 17:16:13 +0000 2018,Most people don‚Äôt know there‚Äôs a whole box of Easter eggs with every Tesla. Just tap logo on center screen &amp; wait.‚Ä¶ https://t.co/CgWaV6amQZ,31080,2382,33462,2018-04-04
1778,981127909170593792,Tue Apr 03 11:14:56 +0000 2018,RT @TIME: SpaceX just launched an experimental space junk sweeper into orbit https://t.co/XCQKxHqQpY,0,2440,2440,2018-04-03
1784,980883549074018304,Mon Apr 02 19:03:56 +0000 2018,@WSJ Tesla policy is to issue a recall *before* there are injuries. This is absolutely the right thing to do. Yet t‚Ä¶ https://t.co/WdOPhZHUSv,40653,5076,45729,2018-04-02
1797,980566101124722688,Sun Apr 01 22:02:31 +0000 2018,"Tesla Goes Bankrupt
Palo Alto, California, April 1, 2018 -- Despite intense efforts to raise money, including a las‚Ä¶ https://t.co/tXEEdimumA",130556,24430,154986,2018-04-01
1799,979904735972024321,Sat Mar 31 02:14:29 +0000 2018,Love seeing the scars of the rocket https://t.co/y5FQrLcV9B,70176,6485,76661,2018-03-31
1806,979726332320915462,Fri Mar 30 14:25:34 +0000 2018,"Attempting recovery of fairing falling down from space (right now) with our boat, Mr Steven. It‚Äôs a giant steel &amp; w‚Ä¶ https://t.co/Mexy7WWh3i",33155,2694,35849,2018-03-30
1809,979172121514520576,Thu Mar 29 01:43:20 +0000 2018,RT @Tesla: Model 3 is Popular Mechanics‚Äô Car of the Year https://t.co/k0a9c4X6Wq,0,2586,2586,2018-03-29
1814,978895114524352513,Wed Mar 28 07:22:36 +0000 2018,"Turns out joking about being a ‚Äúrock‚Äù star because of digging tunnels (through, uh, rock ‚Äî hello??) is deeply underappreciated",107029,9377,116406,2018-03-28
1816,978502181069365249,Tue Mar 27 05:21:14 +0000 2018,"From my Mom: every time I use irony, I lose a friend",77215,9221,86436,2018-03-27
1824,978140940241059840,Mon Mar 26 05:25:47 +0000 2018,New Boring Company merch coming soon. Lifesize LEGO-like interlocking bricks made from tunneling rock that you can‚Ä¶ https://t.co/wr97P3OICT,74277,8904,83181,2018-03-26
1826,978056724950147072,Sun Mar 25 23:51:09 +0000 2018,https://t.co/C98mW0OPAF,30887,1752,32639,2018-03-25
1828,977660603975151616,Sat Mar 24 21:37:06 +0000 2018,@TeslaMotorsClub It‚Äôs not a political statement and I didn‚Äôt do this because someone dared me to do it. Just don‚Äôt‚Ä¶ https://t.co/ZgzwRO26pK,30810,4142,34952,2018-03-24
1843,977209817012977665,Fri Mar 23 15:45:50 +0000 2018,@brianacton What‚Äôs Facebook?,49479,13637,63116,2018-03-23
1859,976761913131524098,Thu Mar 22 10:06:02 +0000 2018,"The Swiss police are smart. Electricity vs diesel &amp; maintenance more than make up for purchase price diff. Plus, th‚Ä¶ https://t.co/OfgGdqSUpz",23642,3142,26784,2018-03-22
1862,976414452106055680,Wed Mar 21 11:05:20 +0000 2018,"@Lori_Garver @JeffBezos Lori, this is ridiculous. Creating a rocket company has to be one of the dumbest and hardes‚Ä¶ https://t.co/pcd5YAl8Wo",29931,3789,33720,2018-03-21
1863,976168329097416704,Tue Mar 20 18:47:20 +0000 2018,@RanNatanzon @Tesla @Cortica This is completely false. Never even heard of Cortica. Just taking my kids on a Spring‚Ä¶ https://t.co/t8IA4nlarQ,14811,858,15669,2018-03-20
1865,975796402675703809,Mon Mar 19 18:09:26 +0000 2018,Learning how to pour flaming absinthe over a tower of glasses in a Jerusalem speakeasy.‚Ä¶ https://t.co/kLFzl7SjH5,15523,1031,16554,2018-03-19
1866,975228272366759939,Sun Mar 18 04:31:53 +0000 2018,@IraEhrenpreis @Tesla Thanks for your support over all those years!,7202,154,7356,2018-03-18
1868,974355745993969664,Thu Mar 15 18:44:47 +0000 2018,@TheOnion Oh you guys ...,28855,1277,30132,2018-03-15
1871,974035192565317632,Wed Mar 14 21:31:01 +0000 2018,"RT @NASA: Remembering Stephen Hawking, a renowned physicist and ambassador of science. His theories unlocked a universe of possibilities th‚Ä¶",0,150765,150765,2018-03-14
1877,972996509477216256,Mon Mar 12 00:43:39 +0000 2018,@prof_wsoff Great idea!,479,22,501,2018-03-12
1880,972628124893671432,Sun Mar 11 00:19:50 +0000 2018,"Why Falcon Heavy &amp; Starman?

Life cannot just be about solving one sad problem after another. There need to be thin‚Ä¶ https://t.co/yiipelSB2Q",103606,30986,134592,2018-03-11
1884,972335273462841344,Sat Mar 10 04:56:08 +0000 2018,Tunnels,22187,3465,25652,2018-03-10
1887,972245615735222273,Fri Mar 09 22:59:52 +0000 2018,"Better video coming soon, but it would look a bit like this: https://t.co/C0iJPi8b4U",118224,31766,149990,2018-03-09
1905,971618409187127296,Thu Mar 08 05:27:35 +0000 2018,https://t.co/pNElNTmcKf,174048,24230,198278,2018-03-08
1911,971224396890124288,Wed Mar 07 03:21:55 +0000 2018,I just realized there is a jazz hands emoji ü§ó,150523,16500,167023,2018-03-07
1913,970914681069039617,Tue Mar 06 06:51:13 +0000 2018,"@SpaceX Very proud of the SpaceX team! Can‚Äôt believe it‚Äôs been fifty Falcon 9 launches already. Just ten years ago,‚Ä¶ https://t.co/Ri6hWnrGpY",32473,3465,35938,2018-03-06
1915,970747812311740416,Mon Mar 05 19:48:08 +0000 2018,"Falcon 9 flight 50 launches tonight, carrying Hispasat for Spain. At 6 metric tons and almost the size of a city bu‚Ä¶ https://t.co/ACEhpZfQTY",70694,10496,81190,2018-03-05
1916,970192640913301504,Sun Mar 04 07:02:05 +0000 2018,"@keithbigelow Very sensible summary of supersonic flight. Obvious answer is to fly high, which gives low drag &amp; low‚Ä¶ https://t.co/krmKkBSTNf",9194,498,9692,2018-03-04
1920,970067019012784128,Sat Mar 03 22:42:54 +0000 2018,"Deep in the hole with my boring machine. Sometimes when we touch, the honesty‚Äôs too much ... https://t.co/pl6ap14tAB",38670,3122,41792,2018-03-03
1921,968707151815376897,Wed Feb 28 04:39:17 +0000 2018,@Pewwer42 Probably about a tenth of the cost and a fifth of the time,820,62,882,2018-02-28
1926,968608879914270721,Tue Feb 27 22:08:47 +0000 2018,China‚Äôs progress in advanced infrastructure is more than 100 times faster than the US https://t.co/fcqGIK78RY,42729,10947,53676,2018-02-27
1930,967712110661615616,Sun Feb 25 10:45:21 +0000 2018,@andrestaltz Will be simpler than IPv6 and have tiny packet overhead. Definitely peer-to-peer.,9160,666,9826,2018-02-25
1932,967238527418167296,Sat Feb 24 03:23:30 +0000 2018,@ElectrekCo @TeslaRoadTrip Am feeling optimistic about beating the Semi specs announced at the unveiling for the sa‚Ä¶ https://t.co/8pmhbx0Yno,16823,1062,17885,2018-02-24
1936,966706924124188672,Thu Feb 22 16:11:05 +0000 2018,"Don‚Äôt tell anyone, but the wifi password is ‚Äúmartians‚Äù",52459,7860,60319,2018-02-22
1952,966298034978959361,Wed Feb 21 13:06:19 +0000 2018,"Today‚Äôs Falcon launch carries 2 SpaceX test satellites for global broadband. If successful, Starlink constellation will serve least served.",74443,10974,85417,2018-02-21
1954,965769366422798337,Tue Feb 20 02:05:34 +0000 2018,@angilly I don‚Äôt get the little ship thing. You can‚Äôt show up at Mars in something the size of a rowboat. What if t‚Ä¶ https://t.co/Aj0zv8Lwdf,66637,10306,76943,2018-02-20
1955,965297598054637568,Sun Feb 18 18:50:56 +0000 2018,"I‚Äôm sure it‚Äôs parked around here somewhere ‚Ä¶
https://t.co/cq4LEhu4qD",67220,12755,79975,2018-02-18
1957,964751491885076480,Sat Feb 17 06:40:54 +0000 2018,My new toaster https://t.co/1pw7xJeLpB,41029,3493,44522,2018-02-17
1958,964296857395478529,Fri Feb 16 00:34:21 +0000 2018,@Teslarati Adding software feature to open glovebox automatically when car comes to a stop after a crash. Will look‚Ä¶ https://t.co/OlM3sV2Ku9,15517,858,16375,2018-02-16
1969,963092110994886656,Mon Feb 12 16:47:07 +0000 2018,"@AngryPackOMeese @dlxinorbit @doug_ellison @dsfpspacefl1ght Maybe that plan works out, but I will seriously eat my‚Ä¶ https://t.co/DgYpjAzu8D",1807,273,2080,2018-02-12
1975,962735351713411072,Sun Feb 11 17:09:29 +0000 2018,Falcon Heavy engine plumes look like giant laser beams in this photo by rocketphotography https://t.co/d1RKdPTNj5,59736,6473,66209,2018-02-11
1977,961083704230674438,Wed Feb 07 03:46:25 +0000 2018,Third burn successful. Exceeded Mars orbit and kept going to the Asteroid Belt. https://t.co/bKhRN73WHF,193504,36929,230433,2018-02-07
1986,960992715579125760,Tue Feb 06 21:44:52 +0000 2018,"View from SpaceX Launch Control. Apparently, there is a car in orbit around Earth. https://t.co/QljN2VnL1O",481000,171854,652854,2018-02-06
2000,960400928225546241,Mon Feb 05 06:33:19 +0000 2018,https://t.co/nhB3gd0Gm6,76632,12494,89126,2018-02-05
2005,960233035516932096,Sun Feb 04 19:26:10 +0000 2018,Pale blue dot https://t.co/KZj3I55EYl,29816,6753,36569,2018-02-04
2009,959585626071842817,Sat Feb 03 00:33:36 +0000 2018,Or maybe ‚ÄúTemperature Enhancement Device‚Äù,113349,11387,124736,2018-02-03
2010,959555569953660928,Fri Feb 02 22:34:10 +0000 2018,"Apparently, some customs agencies are saying they won‚Äôt allow shipment of anything called a ‚ÄúFlamethrower‚Äù. To solv‚Ä¶ https://t.co/OCtjvdXo95",381935,76869,458804,2018-02-02
2019,958931799391924224,Thu Feb 01 05:15:31 +0000 2018,Flamethrowers sold out,154636,20587,175223,2018-02-01
2022,958847818583584768,Wed Jan 31 23:41:49 +0000 2018,"This rocket was meant to test very high retrothrust landing in water so it didn‚Äôt hurt the droneship, but amazingly‚Ä¶ https://t.co/wAIBtlLyTz",50902,5994,56896,2018-01-31
2030,958371267203145729,Tue Jan 30 16:08:10 +0000 2018,15k,19165,748,19913,2018-01-30
2038,957787361630236672,Mon Jan 29 01:27:56 +0000 2018,"But wait, there‚Äôs more: the flamethrower is sentient, its safe word is ‚Äúcryptocurrency‚Äù and it comes with a free blockchain",116624,18478,135102,2018-01-29
2042,957494364028071936,Sun Jan 28 06:03:40 +0000 2018,The rumor that I‚Äôm secretly creating a zombie apocalypse to generate demand for flamethrowers is completely false,380695,100273,480968,2018-01-28
2054,957361443023695872,Sat Jan 27 21:15:29 +0000 2018,Aiming for first flight of Falcon Heavy on Feb 6 from Apollo launchpad 39A at Cape Kennedy. Easy viewing from the public causeway.,60464,11800,72264,2018-01-27
2056,956233892637286400,Wed Jan 24 18:35:00 +0000 2018,Falcon Heavy hold-down firing this morning was good. Generated quite a thunderhead of steam. Launching in a week or‚Ä¶ https://t.co/2e6EEIKZw4,87326,14766,102092,2018-01-24
2057,954110572315918337,Thu Jan 18 21:57:41 +0000 2018,RT @business: Alibaba's artificial intelligence has scored better than humans in a Stanford reading test https://t.co/BIQuU3vhJ1 https://t.‚Ä¶,0,1980,1980,2018-01-18
2059,952964012009971712,Mon Jan 15 18:01:40 +0000 2018,"RT @AnthonyLacavera: Safe #AI for all, @elonmusk's @OpenAI is looking to expand its team &amp; continue on its goal of creating AI that does no‚Ä¶",0,1276,1276,2018-01-15
2062,952049059291803648,Sat Jan 13 05:25:58 +0000 2018,@DanielleFong @YoungTreeGrower @TylerDoor @ID_AA_Carmack There aren‚Äôt even good normal parties in Silicon Valley!,961,112,1073,2018-01-13
2063,951893894605586432,Fri Jan 12 19:09:24 +0000 2018,"@ID_AA_Carmack @DanielleFong Actually, you can upgrade the battery pack for a huge improvement in range and some im‚Ä¶ https://t.co/qaSM83VkwK",546,44,590,2018-01-12
2065,950600363630931968,Tue Jan 09 05:29:22 +0000 2018,@PPathole @Tesla @Teslarati @MKBHD Fixed in next release,8683,206,8889,2018-01-09
2066,950416244997488640,Mon Jan 08 17:17:45 +0000 2018,"Long exposure of rocket ascent, reentry from space and landing burn. (Credit @johnkrausphotos) https://t.co/X24k3han8M",21947,3355,25302,2018-01-08
2071,949831212326993920,Sun Jan 07 02:33:02 +0000 2018,"Gonna put an old school drive-in, roller skates &amp; rock restaurant at one of the new Tesla Supercharger locations in LA",190353,17956,208309,2018-01-07
2074,949075475036487680,Fri Jan 05 00:30:00 +0000 2018,Falcon Heavy goes vertical https://t.co/uG1k0WISv1,93737,16826,110563,2018-01-05
2076,948428274467618816,Wed Jan 03 05:38:16 +0000 2018,Come work at the biggest &amp; most advanced factory on Earth! Located by a river near the beautiful Sierra Nevada moun‚Ä¶ https://t.co/ydi2rIRPhF,58815,8196,67011,2018-01-03
2078,945814723521417217,Wed Dec 27 00:32:57 +0000 2017,@neilsiegel @Tesla Coming very soon,2540,73,2613,2017-12-27
2090,945712432416137217,Tue Dec 26 17:46:29 +0000 2017,Wanted again to send a note of deep gratitude to Tesla owners WW for taking a chance on a new company that all expe‚Ä¶ https://t.co/IXOsJvjRjG,140915,13806,154721,2017-12-26
2091,945100013973020672,Mon Dec 25 01:12:57 +0000 2017,"@Nicmedia123 We will! At least, whatever is left over after we build the obelisks.",2611,104,2715,2017-12-25
2097,944787213430034432,Sun Dec 24 04:29:59 +0000 2017,So strange that people often believe things inversely proportionate to the evidence. Given a set of possible explan‚Ä¶ https://t.co/WpJtntigln,111948,24790,136738,2017-12-24
2106,944399853316055040,Sat Dec 23 02:50:45 +0000 2017,Nuclear alien UFO from North Korea https://t.co/GUIHpKkkp5,312485,99270,411755,2017-12-23
2111,943901463998169088,Thu Dec 21 17:50:20 +0000 2017,I love Twitter,189856,37152,227008,2017-12-21
2127,943420026593337344,Wed Dec 20 09:57:16 +0000 2017,Falcon Heavy at the Cape https://t.co/hizfDVsU7X,132391,29119,161510,2017-12-20
2129,943196385373052934,Tue Dec 19 19:08:36 +0000 2017,Thanks! https://t.co/dr3cFPSXje,87139,10849,97988,2017-12-19
2132,942631094519660544,Mon Dec 18 05:42:20 +0000 2017,RT @EricTopol: Yet another #AI milestone: superhuman performance in no-limit poker for the 1st time (wow) https://t.co/gVP2h7YFjR @sciencem‚Ä¶,0,1381,1381,2017-12-18
2135,942524031185575937,Sun Dec 17 22:36:54 +0000 2017,@slashdot @mavtechie @FlatEarthOrg I also support the Concave Earth and Hollow Globe Societies. Just covering my bases ‚Ä¶,591,52,643,2017-12-17
2137,941885122499899397,Sat Dec 16 04:18:07 +0000 2017,42k,17772,1202,18974,2017-12-16
2142,941500121564332032,Fri Dec 15 02:48:15 +0000 2017,@humantransit You‚Äôre an idiot,41702,5552,47254,2017-12-15
2147,941388347183841280,Thu Dec 14 19:24:06 +0000 2017,"10 hat aficionados, in appreciation for their exquisite taste in millinery, will be picked at random to tour the LA‚Ä¶ https://t.co/Hg3a3nWLGe",23373,1736,25109,2017-12-14
2149,941042298283966464,Wed Dec 13 20:29:02 +0000 2017,It is high time that humanity went beyond Earth. Should have a moon base by now and sent astronauts to Mars. The fu‚Ä¶ https://t.co/Kzvu6jcAdR,71683,15347,87030,2017-12-13
2150,940620874952073216,Tue Dec 12 16:34:27 +0000 2017,"35,000",26079,2174,28253,2017-12-12
2154,940056523304181762,Mon Dec 11 03:11:55 +0000 2017,"After 50k hats, we will start selling The Boring Company flamethrower",73321,9881,83202,2017-12-11
2157,938972633416306690,Fri Dec 08 03:24:55 +0000 2017,"On Tuesday, SpaceX will attempt to refly both an orbital rocket and spacecraft for the first‚Ä¶ https://t.co/Wm5SpjNdMb",29010,4448,33458,2017-12-08
2159,938816780444745728,Thu Dec 07 17:05:37 +0000 2017,@FortuneTech Do it,104911,22789,127700,2017-12-07
2167,937402084692975616,Sun Dec 03 19:24:07 +0000 2017,Every 5000th buyer of our boringly boring hat will get a free hat signed by the delivery guy https://t.co/11TYEUSG4M,27726,3146,30872,2017-12-03
2178,936782477502246912,Sat Dec 02 02:22:01 +0000 2017,Payload will be my midnight cherry Tesla Roadster playing Space Oddity. Destination is Mars orbit. Will be in deep‚Ä¶ https://t.co/clunBATxJr,82853,17047,99900,2017-12-02
2187,936060082290167808,Thu Nov 30 02:31:29 +0000 2017,"The Boring Company will compete to fund, build &amp; operate a high-speed Loop connecting Chicago O‚ÄôHare Airport to dow‚Ä¶ https://t.co/33qhtJbFbo",36365,6849,43214,2017-11-30
2188,935572279693516800,Tue Nov 28 18:13:08 +0000 2017,Why is there no Flat Mars Society!?,97336,29043,126379,2017-11-28
2194,935250797234753536,Mon Nov 27 20:55:40 +0000 2017,"@WorldAndScience Wow, they played D&amp;D in D&amp;D",14248,1653,15901,2017-11-27
2198,934888089058549760,Sun Nov 26 20:54:24 +0000 2017,"This is nothing. In a few years, that bot will move so fast you‚Äôll need a strobe light to see it. Sweet dreams‚Ä¶ https://t.co/0MYNixQXMw",271332,89364,360696,2017-11-26
2199,934505268343394307,Sat Nov 25 19:33:12 +0000 2017,"Thanksgiving in the Rockies. Love my bro @kimbal. Radishing t-shirt courtesy of his company,‚Ä¶ https://t.co/FB6rTbFdK8",7895,395,8290,2017-11-25
2200,934024631769534464,Fri Nov 24 11:43:20 +0000 2017,@bjornlilja Adjusting soon,316,16,332,2017-11-24
2201,933576358793318401,Thu Nov 23 06:02:03 +0000 2017,Congratulations to the Tesla crew and South Australian authorities who worked so hard to get this manufactured and‚Ä¶ https://t.co/xLOhH7EXiQ,40868,7954,48822,2017-11-23
2202,933077329722580992,Tue Nov 21 20:59:05 +0000 2017,Initial Hat Offering going great w over $300k in hat sales already! Thanks for buying our super boring hat. You roc‚Ä¶ https://t.co/PpmDpNyNXT,14990,1491,16481,2017-11-21
2203,932649922666438656,Mon Nov 20 16:40:44 +0000 2017,@schesnais Good point,386,21,407,2017-11-20
2206,932113939181092864,Sun Nov 19 05:10:55 +0000 2017,Should clarify that this is the base model performance. There will be a special option package that takes it to the next level.,60120,8304,68424,2017-11-19
2208,931407490889084928,Fri Nov 17 06:23:45 +0000 2017,0 to 100 km/h in 1.9 sec https://t.co/xTOTDGuwQj,459610,118387,577997,2017-11-17
2210,930875739397791744,Wed Nov 15 19:10:45 +0000 2017,"It can transform into a robot, fight aliens and make one hell of a latte https://t.co/8h9vvWu4f5",75706,15295,91001,2017-11-15
2215,930100328229244928,Mon Nov 13 15:49:33 +0000 2017,@newscientist ... say scientists ‚Äî among other insights gained ‚Äî after a large vat of LSD overturned in the lab. Al‚Ä¶ https://t.co/zTamxyErGn,13257,2105,15362,2017-11-13
2216,929823757635481600,Sun Nov 12 21:30:33 +0000 2017,Tesla Semi Truck unveil to be webcast live on Thursday at 8pm! This will blow your mind clear out of your skull and‚Ä¶ https://t.co/3yKRDpCUqZ,119664,27030,146694,2017-11-12
2218,929090906606542848,Fri Nov 10 20:58:28 +0000 2017,@newscientist Sure ...,21253,2759,24012,2017-11-10
2219,928675794372608001,Thu Nov 09 17:28:57 +0000 2017,"""If one day, my words are against science, choose science.""
Mustafa Kemal Atat√ºrk",206197,89763,295960,2017-11-09
2221,928335114353831937,Wed Nov 08 18:55:13 +0000 2017,Atat√ºrk Anƒ±tkabir https://t.co/al3wt0njr6,115653,28917,144570,2017-11-08
2222,927986199079264256,Tue Nov 07 19:48:45 +0000 2017,"@Bob_Richards One rocket, slightly toasted",7271,402,7673,2017-11-07
2223,925024279938269184,Mon Oct 30 15:39:09 +0000 2017,RT @SpaceX: Falcon 9 and Koreasat-5A went vertical last night on Pad 39A. Today‚Äôs launch window opens at 3:34 p.m. EDT ‚Üí https://t.co/gtC39‚Ä¶,0,1755,1755,2017-10-30
2225,924387972161552384,Sat Oct 28 21:30:41 +0000 2017,Picture of The Boring Company LA tunnel taken yesterday https://t.co/TfdVKyXFsJ,60084,8650,68734,2017-10-28
2226,923657991664095232,Thu Oct 26 21:10:00 +0000 2017,"Btw, just want to express a word of appreciation for the hard work of the Tesla Gigafactory team. Reason I camped o‚Ä¶ https://t.co/Nztp84BSLW",42445,3561,46006,2017-10-26
2235,922691827031068672,Tue Oct 24 05:10:49 +0000 2017,"On the list of people who should absolutely *not* be allowed to develop digital superintelligence...
https://t.co/reNZ50FGNC",23202,6573,29775,2017-10-24
2238,921575783813939200,Sat Oct 21 03:16:03 +0000 2017,"@atlasobscura A reminder of the youth of our 10,000 year (to be generous) civilization. We are not even a flash in‚Ä¶ https://t.co/FXEDnXjwoh",12350,1961,14311,2017-10-21
2241,921177181585154048,Fri Oct 20 00:52:09 +0000 2017,RT @RickandMorty: Simulation theory confirmed. https://t.co/2sAHlIXV4v,0,15142,15142,2017-10-20
2245,920845980467163139,Thu Oct 19 02:56:04 +0000 2017,It all comes full circle https://t.co/zqiCDLhFWy,29749,2948,32697,2017-10-19
2252,920482298327216128,Wed Oct 18 02:50:56 +0000 2017,The world's most boring hat  https://t.co/rnHPgyhx4Z,23064,3376,26440,2017-10-18
2253,919999012899454976,Mon Oct 16 18:50:32 +0000 2017,Amazing sim of neutron stars colliding https://t.co/E38rna81TK,16692,4222,20914,2017-10-16
2255,919675564423708673,Sun Oct 15 21:25:15 +0000 2017,Yesterday's Reddit Ask Me Anything about BFR. You're welcome nk! https://t.co/g2giimsW8b,8637,1438,10075,2017-10-15
2256,919262509227323392,Sat Oct 14 18:03:55 +0000 2017,BFR AMA on r/space in 2 hours,14371,1880,16251,2017-10-14
2262,918333638567186438,Thu Oct 12 04:32:55 +0000 2017,Stamping Model 3 Body Panels (real-time) https://t.co/hhNFW8VUEE,12705,1729,14434,2017-10-12
2269,918167666908528640,Wed Oct 11 17:33:25 +0000 2017,RT @SpaceX: Falcon 9 and EchoStar 105/SES-11 went vertical last night on Pad 39A. https://t.co/WWLoIobQb3,0,1471,1471,2017-10-11
2272,917413806363394048,Mon Oct 09 15:37:50 +0000 2017,The last of ten Iridium global communication satellites delivered to orbit several hundred miles‚Ä¶ https://t.co/TG7hNkltQd,9971,1129,11100,2017-10-09
2278,917153183222263808,Sun Oct 08 22:22:13 +0000 2017,Jupiter is big https://t.co/poXgvKPZv7,29208,4549,33757,2017-10-08
2281,916782879962574848,Sat Oct 07 21:50:46 +0000 2017,@verge This doesn't even *seem* innocent,27872,4313,32185,2017-10-07
2297,916395155120205825,Fri Oct 06 20:10:05 +0000 2017,Tesla Semi unveil now Nov 16. Diverting resources to fix Model 3 bottlenecks &amp; increase battery production for Puer‚Ä¶ https://t.co/VfWMLeTAwN,54271,9774,64045,2017-10-06
2309,915831795446190085,Thu Oct 05 06:51:30 +0000 2017,@RickandMorty Final episode was disgustingly good,58269,9744,68013,2017-10-05
2311,915453138051768320,Wed Oct 04 05:46:51 +0000 2017,Aiming for two rocket landings in 48 hours this weekend https://t.co/C1CZW2cQgv,24501,3476,27977,2017-10-04
2312,914948623208611840,Mon Oct 02 20:22:05 +0000 2017,"RT @WIRED: GM just announced that it is working toward an all-electric, zero-emissions future https://t.co/fjSzkACMEO",0,2099,2099,2017-10-02
2319,913649379281534976,Fri Sep 29 06:19:21 +0000 2017,Fly to most places on Earth in under 30 mins and anywhere in under 60. Cost per seat should be‚Ä¶ https://t.co/dGYDdGttYd,39759,14712,54471,2017-09-29
2324,913547943646580737,Thu Sep 28 23:36:17 +0000 2017,Will be announcing something really special at today's talk https://t.co/plXTBJY6ia,22001,4944,26945,2017-09-28
2329,912833915475386368,Wed Sep 27 00:18:59 +0000 2017,"Prev ideas for paying ~$10B dev cost incl. Kickstarter &amp; collecting underpants, which turned out to be um... less lucrative than expected",11576,1125,12701,2017-09-27
2331,912649053334265856,Tue Sep 26 12:04:25 +0000 2017,"@El_Deano @Daimler @Jalopnik Yes, I did :)",20163,2004,22167,2017-09-26
2336,912259150175813633,Mon Sep 25 10:15:05 +0000 2017,Major improvements &amp; some unexpected applications to be unveiled on Friday at @IAC2017 in Australia,11120,1605,12725,2017-09-25
2338,912036765287845888,Sun Sep 24 19:31:24 +0000 2017,@USATODAYmoney @NathanBomey That's not a lot of money for a giant like Daimler/Mercedes. Wish they'd do more. Off by a zero.,21689,3348,25037,2017-09-24
2339,911010134557462528,Thu Sep 21 23:31:56 +0000 2017,"RT @MotorTrend: Shocking winner of our latest, World's Greatest Drag Race 7! Maybe even #ludicrous? #WGDR7 https://t.co/ImvNAm2Yop",0,2140,2140,2017-09-21
2340,910540337935826944,Wed Sep 20 16:25:08 +0000 2017,"@Its_Subhamk Don't give up if the cause is important enough, even if you believe you are walking into doom. Good friends really matter.",18098,4218,22316,2017-09-20
2341,910180847814197248,Tue Sep 19 16:36:39 +0000 2017,"@JimHeaney Absolutely. Moreover, we expect to expand the facility significantly over time.",1636,94,1730,2017-09-19
2343,908877302418726912,Sat Sep 16 02:16:49 +0000 2017,@Bobby_Gupta Def not ok. Just sent a reminder to Tesla stores that we just want people to look forward to their nex‚Ä¶ https://t.co/z4KuEhvl4a,10522,429,10951,2017-09-16
2346,908715328112271360,Fri Sep 15 15:33:11 +0000 2017,@bonnienorman Of course :),1480,34,1514,2017-09-15
2349,908254079092002816,Thu Sep 14 09:00:21 +0000 2017,"Long road to reusabity of Falcon 9 primary boost stage‚Ä¶When upper stage &amp; fairing also reusable, costs will drop by‚Ä¶ https://t.co/omqxEl6hCU",32174,9901,42075,2017-09-14
2351,908108029777686528,Wed Sep 13 23:20:00 +0000 2017,Tesla Semi truck unveil &amp; test ride tentatively scheduled for Oct 26th in Hawthorne. Worth seeing this beast in person. It's unreal.,72258,15175,87433,2017-09-13
2355,907483778603294720,Tue Sep 12 05:59:27 +0000 2017,@hohocho Yes,4220,231,4451,2017-09-12
2358,906274454946402304,Fri Sep 08 21:54:02 +0000 2017,Astronaut spacesuit next to Crew Dragon https://t.co/Csmgx8Nn0t,18695,4320,23015,2017-09-08
2359,905910267262926848,Thu Sep 07 21:46:53 +0000 2017,RT @SpaceX: More photos from today‚Äôs Falcon 9 launch and first stage landing ‚Üí https://t.co/095WHWMtKp https://t.co/TpFnWS9GI9,0,3456,3456,2017-09-07
2369,904633084309422080,Mon Sep 04 09:11:49 +0000 2017,It begins ... https://t.co/mbjw5hWC5J,85833,35818,121651,2017-09-04
2370,903333005527093248,Thu Aug 31 19:05:46 +0000 2017,"Putting together SpaceX rocket landing blooper reel. We messed up a lot before it finally worked, but there's some epic explosion footage ‚Ä¶",42931,5425,48356,2017-08-31
2376,902913054723022850,Wed Aug 30 15:17:02 +0000 2017,"@ChaseBlackmon1 @boringcompany Not sure, but probably",3153,148,3301,2017-08-30
2380,902452162625544193,Tue Aug 29 08:45:36 +0000 2017,"Worth reading Life 3.0 by @Tegmark. AI will be the best or worst thing ever for humanity, so let‚Äôs get it right.
https://t.co/lT0uMH3ujZ",15908,3757,19665,2017-08-29
2389,902039243601485824,Mon Aug 28 05:24:49 +0000 2017,Hyperloop pod run by team WARR https://t.co/ntaMsoxkZE,128159,46843,175002,2017-08-28
2402,901904354126520321,Sun Aug 27 20:28:49 +0000 2017,https://t.co/IypZm9FdQk,9236,4441,13677,2017-08-27
2411,901238166237069313,Sat Aug 26 00:21:37 +0000 2017,"@Techmeme Tesla does not really have ""TTunes"". That's a joke.",1153,110,1263,2017-08-26
2424,900947535358967808,Fri Aug 25 05:06:45 +0000 2017,Falcon 9 boost stage on droneship Just Read the Instructions https://t.co/fZTPmwsnOz,31020,4505,35525,2017-08-25
2425,900812511267520512,Thu Aug 24 20:10:13 +0000 2017,RT @SpaceX: Successful deployment of FORMOSAT-5 to low-Earth orbit confirmed. https://t.co/PiB7r3Zk4F,0,1888,1888,2017-08-24
2429,900413265313792000,Wed Aug 23 17:43:45 +0000 2017,New Model X SUV now faster than a $500k Lamborghini https://t.co/J23AKNMnmV,35909,9989,45898,2017-08-23
2436,899872164106481664,Tue Aug 22 05:53:37 +0000 2017,@brijwaasi I can't hide the truth any more ‚Ä¶,34800,5764,40564,2017-08-22
2439,899682569951760384,Mon Aug 21 17:20:14 +0000 2017,Watching eclipse with sunglasses on through the Model S glass roof. Wow!,43332,4348,47680,2017-08-21
2444,899075756508065793,Sun Aug 20 01:08:59 +0000 2017,Pics of SpaceX spacesuit developed for NASA commercial crew program coming out next week. Undergoing ocean landing mobility/safety tests.,30089,4221,34310,2017-08-20
2452,898713949125787650,Sat Aug 19 01:11:17 +0000 2017,@pjfranks1509 Good point. We will add that to all cars in one of the upcoming software releases.,9189,494,9683,2017-08-19
2453,898659784307515392,Fri Aug 18 21:36:03 +0000 2017,@robcrawford08 I love Kermit,27187,3374,30561,2017-08-18
2458,897232757629173760,Mon Aug 14 23:05:33 +0000 2017,"Tesla Powerwalls can support houses of any size, but the cool thing is we can tow this house around with a Model X! https://t.co/MmQl8BPetY",23085,4634,27719,2017-08-14
2464,896762461574938625,Sun Aug 13 15:56:46 +0000 2017,First draft animation of the Falcon Heavy three core launch. FH is twice the thrust of the next‚Ä¶ https://t.co/vgZxF6ugoh,9588,1977,11565,2017-08-13
2470,896169801277517824,Sat Aug 12 00:41:45 +0000 2017,"Nobody likes being regulated, but everything (cars, planes, food, drugs, etc) that's a danger to the public is regulated. AI should be too.",74099,20896,94995,2017-08-12
2479,895866249669820418,Fri Aug 11 04:35:32 +0000 2017,@TIME This is about as true as TIME being a paragon of great journalism. Please spend at least 8 seconds checking your facts.,31701,5424,37125,2017-08-11
2487,895512698145976320,Thu Aug 10 05:10:39 +0000 2017,@LWRGI Major increases in the Supercharger and Tesla urban charger network happening over the next several months,4002,325,4327,2017-08-10
2488,894346282642354178,Sun Aug 06 23:55:44 +0000 2017,First draft animation of the Falcon Heavy three core launch. FH is twice the thrust of the next‚Ä¶ https://t.co/vgZxF6LRMR,13128,2990,16118,2017-08-06
2500,893920554821931008,Sat Aug 05 19:44:03 +0000 2017,Officially verified as the first production electric car to exceed 1000km on a single charge! Congratulations Tesla‚Ä¶ https://t.co/B7umKT455U,52818,14806,67624,2017-08-05
2501,893416227967717376,Fri Aug 04 10:20:02 +0000 2017,@GuardianSustBiz I guess a proof of concept is needed,10452,766,11218,2017-08-04
2502,893176500005908482,Thu Aug 03 18:27:26 +0000 2017,"Looking forward to launching @NASA astronauts to the International Space Station next year!
https://t.co/qoLtTEP4L8",29055,6424,35479,2017-08-03
2506,892545286748258305,Wed Aug 02 00:39:13 +0000 2017,We poured our heart into the car. Hope you love it. https://t.co/DZOgQUfENo,35348,5720,41068,2017-08-02
2507,892216736497319936,Tue Aug 01 02:53:41 +0000 2017,Sure hope so https://t.co/VJclNI3I2F,24192,3291,27483,2017-08-01
2511,891911665821786112,Mon Jul 31 06:41:26 +0000 2017,@verge Umm ... https://t.co/bjJ0lNYK35,49433,7671,57104,2017-07-31
2517,891710778205626368,Sun Jul 30 17:23:11 +0000 2017,"@EricDiepeveen The reality is great highs, terrible lows and unrelenting stress. Don't think people want to hear about the last two.",23913,6124,30037,2017-07-30
2530,891108125842878464,Sat Jul 29 01:28:27 +0000 2017,First! https://t.co/OXNEgDnhku,21166,3059,24225,2017-07-29
2540,890765027032039429,Fri Jul 28 02:45:06 +0000 2017,Falcon Heavy maiden launch this November https://t.co/D4Dxq9d6hc,15345,3609,18954,2017-07-28
2541,890676198874824706,Thu Jul 27 20:52:08 +0000 2017,@mathetes76 Tesla team will verify,978,22,1000,2017-07-27
2545,890096103135358982,Wed Jul 26 06:27:02 +0000 2017,Testing The Boring Company car elevator https://t.co/zZkFz6ATGY,16340,3375,19715,2017-07-26
2549,889743782387761152,Tue Jul 25 07:07:03 +0000 2017,@dcunni @SVbizjournal I've talked to Mark about this. His understanding of the subject is limited.,35479,9180,44659,2017-07-25
2555,888555494763241472,Sat Jul 22 00:25:13 +0000 2017,"@andygen21 @Teslarati Yes, I postponed publishing in order to present the updated interplanetary rocket &amp; spaceship‚Ä¶ https://t.co/eyTev6VyTw",664,82,746,2017-07-22
2556,888541666122113024,Fri Jul 21 23:30:16 +0000 2017,Discussing physics of tunnels with Mayor Vargas (who has a physics background). Hawthorne support for The Boring Co‚Ä¶ https://t.co/Doh7qwm8DM,18666,2874,21540,2017-07-21
2569,888053175155949572,Thu Jul 20 15:09:10 +0000 2017,Just received verbal govt approval for The Boring Company to build an underground NY-Phil-Balt-DC Hyperloop. NY-DC in 29 mins.,196655,70402,267057,2017-07-20
2570,887782904360816640,Wed Jul 19 21:15:13 +0000 2017,"@jeff_foust Plan is to do powered landings on Mars for sure, but with a vastly bigger ship",4079,534,4613,2017-07-19
2571,887394908264210432,Tue Jul 18 19:33:27 +0000 2017,RT @TheOnion: New MIT Study Suggests Sonic The Hedgehog Might Be Living In Computer Simulation https://t.co/kIlw13UWM0 https://t.co/sobOGxk‚Ä¶,0,2832,2832,2017-07-18
2578,887027300042104832,Mon Jul 17 19:12:43 +0000 2017,"I should clarify: Tesla stock is obviously high based on past &amp; present, but low if you believe in Tesla's future.‚Ä¶ https://t.co/XzG3z7jo0A",23040,4590,27630,2017-07-17
2580,886456382018408448,Sun Jul 16 05:24:05 +0000 2017,"RT @tanyaofmars: 20. Because this can never be shared enough: @MarsCuriosity took images as it was landing &amp; the result was AWESOME:

https‚Ä¶",0,1608,1608,2017-07-16
2582,886019702736039936,Sat Jul 15 00:28:53 +0000 2017,"@fcingolani It is true, so fine by me",1342,40,1382,2017-07-15
2584,885921115435974657,Fri Jul 14 17:57:08 +0000 2017,It's what you don't say,35952,14073,50025,2017-07-14
2600,885631423306006528,Thu Jul 13 22:46:00 +0000 2017,"Worth noting that Boeing/Lockheed (""Other US"" on chart) get a billion dollar annual subsidy even if they launch not‚Ä¶ https://t.co/5MSaR0GwcR",19400,4818,24218,2017-07-13
2602,885265133944979456,Wed Jul 12 22:30:30 +0000 2017,Going over the small nuances of Model 3 production. Very important that nothing sounds tinny. https://t.co/q3Aj3Yq8J8,8926,962,9888,2017-07-12
2615,884580654117076992,Tue Jul 11 01:10:37 +0000 2017,"Thanks PayPal for allowing me to buy back https://t.co/bOUOejO16Y! No plans right now, but it has great sentimental value to me.",31015,3582,34597,2017-07-11
2617,883900030163324930,Sun Jul 09 04:06:03 +0000 2017,First Production Model 3 https://t.co/TCa2NSUNI3,150189,41323,191512,2017-07-09
2623,883632780264914945,Sat Jul 08 10:24:06 +0000 2017,"Stop biting my finger dammit 
https://t.co/Xh4XHzCWcv
https://t.co/IAlG7khUP4",8663,1112,9775,2017-07-08
2626,883169447472750592,Fri Jul 07 03:42:59 +0000 2017,This will be the highest power battery system in the world by a factor of 3. Australia rocks!! https://t.co/c1DD7xtC90,34039,9299,43338,2017-07-07
2627,882939670895755264,Thu Jul 06 12:29:56 +0000 2017,"@newscientist The world's population is accelerating towards collapse, but few seem to notice or care",10628,3054,13682,2017-07-06
2629,882727063525797889,Wed Jul 05 22:25:06 +0000 2017,SpaceX team reviewed all systems again late last night. Done our best to ensure all is good. https://t.co/R3YrF6PEt4,9037,1081,10118,2017-07-05
2630,882117255407980545,Tue Jul 04 06:01:57 +0000 2017,@SpaceX We're going to spend the 4th doing a full review of rocket &amp; pad systems. Launch no earlier than 5th/6th. O‚Ä¶ https://t.co/TH4zadUFb1,8728,1078,9806,2017-07-04
2631,882007043472728064,Mon Jul 03 22:44:00 +0000 2017,Wanted to say thanks to all that own or ordered a Tesla. It matters to us that you took a risk on a new car company. We won't forget.,74447,8400,82847,2017-07-03
2637,881573728416481280,Sun Jul 02 18:02:10 +0000 2017,Another SpaceX launch today if weather is good https://t.co/UdUYn8Kf0C,14092,2119,16211,2017-07-02
2646,880673804028194817,Fri Jun 30 06:26:11 +0000 2017,Perspective https://t.co/4DW9csSmtl,20217,2069,22286,2017-06-30
2662,880240049677357057,Thu Jun 29 01:42:36 +0000 2017,I love floors,57560,20978,78538,2017-06-29
2665,880201464370442240,Wed Jun 28 23:09:17 +0000 2017,No longer waiting for Godot. It has begun boring and just completed the first segment of tunnel in LA.,19044,2833,21877,2017-06-28
2666,879412656016285696,Mon Jun 26 18:54:50 +0000 2017,"Good summary of rocket landing history. There were two successful water landings much earlier, but they didn't surv‚Ä¶ https://t.co/CNxoM9Oj9R",17902,5412,23314,2017-06-26
2673,879080848359686144,Sun Jun 25 20:56:21 +0000 2017,New titanium grid fins worked even better than expected. Should be capable of an indefinite number of flights with no service.,24370,2971,27341,2017-06-25
2686,878407054083317760,Sat Jun 24 00:18:56 +0000 2017,@sajo Sticking to 100,557,16,573,2017-06-24
2688,878334920141135872,Fri Jun 23 19:32:18 +0000 2017,"Rocket is extra toasty and hit the deck hard (used almost all of the emergency crush core), but otherwise good",24609,3611,28220,2017-06-23
2698,877930155540336640,Thu Jun 22 16:43:54 +0000 2017,Must remember that irony and social media are not friends. Keep forgetting. Dammit.,25733,4654,30387,2017-06-22
2703,877469994593820674,Wed Jun 21 10:15:23 +0000 2017,Over 1000 km should be possible in a 100D with the right tires https://t.co/8czN3dVZE4,20047,4553,24600,2017-06-21
2708,877210236502786048,Tue Jun 20 17:03:12 +0000 2017,No need to rely on scientists for global warming -- just use a thermometer https://t.co/0PbtAL8uRK,15361,5644,21005,2017-06-20
2713,876829309695967232,Mon Jun 19 15:49:32 +0000 2017,@shashwatbakhshi No plans to change cell form factor for X and S,169,17,186,2017-06-19
2725,876492802648965120,Sun Jun 18 17:32:23 +0000 2017,It's time they knew ‚Ä¶ https://t.co/wt7XfXqTM6,33815,4464,38279,2017-06-18
2728,875913504451985411,Sat Jun 17 03:10:27 +0000 2017,Colonizing Mars (thanks Prof Hubbard for creating this from my talk). Major changes to the plan coming soon. https://t.co/s59qMHUj5O,10445,2840,13285,2017-06-17
2729,875849793204928512,Fri Jun 16 22:57:17 +0000 2017,"Hawthorne, California https://t.co/d5qRlN0XQ7",25764,6437,32201,2017-06-16
2734,875070931537981441,Wed Jun 14 19:22:22 +0000 2017,@jasveer10 In discussions with the government of India requesting temporary relief on import penalties/restrictions‚Ä¶ https://t.co/pla865ZLne,3771,1115,4886,2017-06-14
2737,874649718659325952,Tue Jun 13 15:28:37 +0000 2017,US govt testing by @NHTSAgov finds Model X to be the safest SUV in history by significant margin https://t.co/zAdb5FQPEI,21116,4865,25981,2017-06-13
2744,873984057431949312,Sun Jun 11 19:23:31 +0000 2017,@ElectrekCo @TeslaRoadTrip HW2 Autopilot release should go wide next weekend with additional smoothness improvements to longitudinal control,597,86,683,2017-06-11
2745,873629817895133184,Sat Jun 10 19:55:54 +0000 2017,"@RajveerJolly We are developing the interplanetary rocket and spaceship to allow anyone to travel to the moon, Mars‚Ä¶ https://t.co/yQ8NzZJx1Y",6856,1269,8125,2017-06-10
2769,873116351316938753,Fri Jun 09 09:55:34 +0000 2017,Few people know that we started Tesla when GM forcibly recalled all electric cars from customers in 2003 &amp; then crushed them in a junkyard,45253,14512,59765,2017-06-09
2800,872869915337805825,Thu Jun 08 17:36:19 +0000 2017,"Just wish they would stop sticking pins in voodoo dolls of me. That hurts, ok?",20261,2146,22407,2017-06-08
2813,872260000491593728,Wed Jun 07 01:12:44 +0000 2017,"A little red wine, vintage record, some Ambien ... and magic!",23169,3833,27002,2017-06-07
2825,871946789305196544,Tue Jun 06 04:28:09 +0000 2017,"I'm not *saying* they're related, but ‚Ä¶ https://t.co/p5d2zkC7e7",31391,6999,38390,2017-06-06
2838,871774429419667457,Mon Jun 05 17:03:15 +0000 2017,Was just at the DMV &amp; dude had the actual sloth from Zootopia on his desk https://t.co/uxPMFX64ba,13409,1751,15160,2017-06-05
2843,871227498809368580,Sun Jun 04 04:49:56 +0000 2017,It's starting to feel kinda normal to reuse rockets. Good. That's how it is for cars &amp; airplanes and how it should be for rockets.,60216,11394,71610,2017-06-04
2845,871076851900325888,Sat Jun 03 18:51:19 +0000 2017,First reflight of a Dragon spacecraft set for later today https://t.co/EW4HsWvlwc,12499,2155,14654,2017-06-03
2847,870458928055803904,Fri Jun 02 01:55:55 +0000 2017,"RT @RobertIger: As a matter of principle, I've resigned from the President's Council over the  #ParisAgreement withdrawal.",0,52060,52060,2017-06-02
2850,870369915894546432,Thu Jun 01 20:02:13 +0000 2017,Am departing presidential councils. Climate change is real. Leaving Paris is not good for America or the world.,527936,221806,749742,2017-06-01
2857,869970236669177856,Wed May 31 17:34:02 +0000 2017,"Don't know which way Paris will go, but I've done all I can to advise directly to POTUS, through others in WH &amp; via councils, that we remain",63398,16684,80082,2017-05-31
2862,869076569876303872,Mon May 29 06:22:55 +0000 2017,@marlomajor A lot,3364,178,3542,2017-05-29
2865,868606773682356224,Sat May 27 23:16:07 +0000 2017,@CurtisHemming @swiftcurlibrary @lloydbrokeit @TeslaMotors Should finish trans-Canada this year. A stop in Swift Current for sure!,526,69,595,2017-05-27
2869,867988709727129604,Fri May 26 06:20:09 +0000 2017,Old-school fidget spinner back when the only things to play with were squirrels and rocks https://t.co/jx1Xc8nu7t,10474,2184,12658,2017-05-26
2872,867632190695235584,Thu May 25 06:43:28 +0000 2017,"Falcon Heavy is this times three. One way or another, launch is guaranteed to be exciting ... https://t.co/FPUNALj0Hd",10109,1992,12101,2017-05-25
2875,867187932343304192,Wed May 24 01:18:09 +0000 2017,@andrewhockings You are right. Going at max speed. Not much time left.,640,51,691,2017-05-24
2879,867146453868724224,Tue May 23 22:33:20 +0000 2017,Feel exactly the same way as A.O. Scott. Particularly loved The Spy Who Loved Me https://t.co/Lar9pNj2Zi,3631,571,4202,2017-05-23
2901,866470387248316416,Mon May 22 01:46:53 +0000 2017,Excited about the Tesla Autopilot software release rolling out next month. New control algorithm feels as smooth as silk.,26625,4487,31112,2017-05-22
2907,866171283167264770,Sun May 21 05:58:21 +0000 2017,@sleepsl8 Yes,164,8,172,2017-05-21
2908,865707097974951936,Fri May 19 23:13:50 +0000 2017,"@WorldAndScience For reason I can't explain, I find #2 especially odd. Also, not a fan of #17. Has led too many peo‚Ä¶ https://t.co/IcKQzQZj8q",1581,189,1770,2017-05-19
2911,865312614082949123,Thu May 18 21:06:18 +0000 2017,RT @creepypuppet: Lady MERA swept in from the sea. First day with the exquisite Amber Heard. (Shot by the talented @jasinboland ) https://t‚Ä¶,0,9394,9394,2017-05-18
2916,864705169618903040,Wed May 17 04:52:32 +0000 2017,What I love about The Boring Company are the low expectations. Nowhere to go but down.,43467,8868,52335,2017-05-17
2919,864541061364035584,Tue May 16 18:00:26 +0000 2017,Robots that learn by example from @OpenAI https://t.co/skXGB2mT6n,4632,1475,6107,2017-05-16
2922,864257650669649920,Mon May 15 23:14:15 +0000 2017,RT @SpaceX: Webcast of Falcon 9 launch is now live ‚Üí https://t.co/gtC39uBC7z,0,893,893,2017-05-15
2927,863551370892238848,Sun May 14 00:27:45 +0000 2017,Worked in Minecraft. Just sayin ...,13545,1946,15491,2017-05-14
2932,863222555208851456,Sat May 13 02:41:09 +0000 2017,"On my cousin's farm in Canada at 17, wearing a hat on a hat https://t.co/U96ClGz5gZ",53454,6937,60391,2017-05-13
2936,863014220282998788,Fri May 12 12:53:18 +0000 2017,"[Warning, this may cause motion sickness or seizures]
This is a test run of our electric sled‚Ä¶ https://t.co/vI3hLirzg9",13320,4892,18212,2017-05-12
2945,862572672676356096,Thu May 11 07:38:45 +0000 2017,"First machine is Godot. Still waiting ... Don't know why, when or where.",8097,1128,9225,2017-05-11
2955,862216356258758662,Wed May 10 08:02:53 +0000 2017,Solar roof can be ordered for almost any country. Deployment this year in the US and overseas next year.,21153,5877,27030,2017-05-10
2960,862074419996278784,Tue May 09 22:38:52 +0000 2017,"If heat death of the universe is the destination, it really is all about the journey https://t.co/icmkmMKhvj https://t.co/0JmKUYAFRq",6449,1584,8033,2017-05-09
2963,861271994288832514,Sun May 07 17:30:19 +0000 2017,Headed to see Guardians 2 w my bro and kids. Loved the first one.,26324,1654,27978,2017-05-07
2974,860373617841807360,Fri May 05 06:00:30 +0000 2017,Thinking about a name for our first tunneling machine ‚Ä¶,14157,2485,16642,2017-05-05
2975,860050049509736448,Thu May 04 08:34:45 +0000 2017,Was just rereading one of my favorites. So beautiful ‚Ä¶ https://t.co/gp0aNnWxcM,4944,809,5753,2017-05-04
2976,859504157148930048,Tue May 02 20:25:34 +0000 2017,RT @MrJc2012: What can I say. P100D is the best car I have ever driven. It's hard to put into words. Ludicrous mode is just nuts. Thank you‚Ä¶,0,413,413,2017-05-02
2984,858905558908190720,Mon May 01 04:46:57 +0000 2017,"My boring TED talk
https://t.co/QNgolyJXMr",29354,10092,39446,2017-05-01
2986,858489574288379904,Sun Apr 30 01:13:59 +0000 2017,"RT @SpaceX: Falcon 9 and NROL-76 vertical on Pad 39-A. Launch window opens tomorrow at 7:00 a.m. EDT, 11:00 UTC. https://t.co/9o3ZMbaev7",0,2378,2378,2017-04-30
2987,858393753928609792,Sat Apr 29 18:53:13 +0000 2017,"RT @350: The #ClimateMarch in Washington DC is moving through the streets, and it is HUGE. https://t.co/tFSme9r7jh",0,20483,20483,2017-04-29
2990,858062753889533952,Fri Apr 28 20:57:57 +0000 2017,Even more boring https://t.co/EfrzLAXwxs,20500,8588,29088,2017-04-28
2992,857427686104289280,Thu Apr 27 02:54:25 +0000 2017,RT @XHNews: Chinese Vice Premier Wang Yang meets with Tesla CEO Elon Musk in Beijing https://t.co/HSM5kxBvYF,0,747,747,2017-04-27
2998,856302986800369664,Mon Apr 24 00:25:16 +0000 2017,RT @realamberheard: https://t.co/ayTosQoe0a,0,5216,5216,2017-04-24
2999,856292321364631554,Sun Apr 23 23:42:53 +0000 2017,"Having moo moo at Moo Moo Gold Coast with amberheard, @CreepyPuppet and @CowanFilms https://t.co/SUM2RYYN7O",3476,330,3806,2017-04-23
3001,855161676705824768,Thu Apr 20 20:50:06 +0000 2017,RT @waitbutwhy: It's finally here: the full story on Neuralink. I knew the future would be nuts but this is a whole other level. https://t.‚Ä¶,0,5626,5626,2017-04-20
3002,854775938654928896,Wed Apr 19 19:17:19 +0000 2017,RT @TeslaMotors: Tesla driver walks away unscathed after ~500-ft fall from a cliff in his Model S. https://t.co/DqnsUgCHKh via @ElectrekCo,0,3199,3199,2017-04-19
3003,854413994072748032,Tue Apr 18 19:19:05 +0000 2017,RT @AAAauto: .@TeslaMotors Model X 75D-Overall Winner of the 2017 AAA Green Car Guide. More info on the winners &amp; car reviews: https://t.co‚Ä¶,0,1261,1261,2017-04-18
3006,854038254982619136,Mon Apr 17 18:26:01 +0000 2017,@pkingdesign Tesla will soon be offering a compelling means of upgrading a 60 to a 75,250,21,271,2017-04-17
3010,852580027178696704,Thu Apr 13 17:51:33 +0000 2017,Tesla Semi truck unveil set for September. Team has done an amazing job. Seriously next level.,53921,15849,69770,2017-04-13
3014,852239986388721664,Wed Apr 12 19:20:21 +0000 2017,Autolist survey finds Tesla used car values are highest and sell fastest https://t.co/KcXFhqwXVa,8339,1762,10101,2017-04-12
3017,850386820793643008,Fri Apr 07 16:36:32 +0000 2017,Feature coming soon that allows one touch access to all discovered Tesla Easter eggs https://t.co/oWU6oq9Jqb,6497,1014,7511,2017-04-07
3018,850048221665558528,Thu Apr 06 18:11:03 +0000 2017,RT @OpenAI: A neural network teaches itself to analyze sentiment after only being trained to predict the next character: https://t.co/hrITH‚Ä¶,0,1919,1919,2017-04-06
3019,849636868052275200,Wed Apr 05 14:56:29 +0000 2017,And so the robots spared humanity ... https://t.co/v7JUJQWfCv,22394,6523,28917,2017-04-05
3022,848935705057280001,Mon Apr 03 16:30:19 +0000 2017,Stormy weather in Shortville ...,11377,3177,14554,2017-04-03
3025,848415356263702528,Sun Apr 02 06:02:38 +0000 2017,@verge It won't matter,1566,221,1787,2017-04-02
3028,848243350993895424,Sat Apr 01 18:39:09 +0000 2017,Technology breakthrough: turns out chemtrails are actually a message from time-traveling aliens describing the secret of teleportation,30611,9387,39998,2017-04-01
3039,847882289581359104,Fri Mar 31 18:44:25 +0000 2017,"Considering trying to bring upper stage back on Falcon Heavy demo flight for full reusability. Odds of success low, but maybe worth a shot.",15582,2670,18252,2017-03-31
3043,847594208219336705,Thu Mar 30 23:39:41 +0000 2017,Incredibly proud of the SpaceX team for achieving this milestone in space! Next goal is reflight within 24 hours.,51251,13068,64319,2017-03-30
3047,847234747747020800,Wed Mar 29 23:51:19 +0000 2017,"If you just downloaded V8.1, tap the the T on center screen three times",5305,750,6055,2017-03-29
3056,846580443797368832,Tue Mar 28 04:31:21 +0000 2017,"Long Neuralink piece coming out on @waitbutwhy in about a week. Difficult to dedicate the time, but existential risk is too high not to.",12635,3610,16245,2017-03-28
3057,845447146111303681,Sat Mar 25 01:28:01 +0000 2017,RT @OpenAI: New research release: overcoming many of Reinforcement Learning's limitations with Evolution Strategies: https://t.co/fVIStOFdoU,0,1143,1143,2017-03-25
3102,845280754871418880,Fri Mar 24 14:26:51 +0000 2017,"Model 3 was going to be called Model E, for obvious dumb humor reasons, but Ford sued to block it, so now it is S3X. Totally different :)",40498,12995,53493,2017-03-24
3114,844970083000578048,Thu Mar 23 17:52:21 +0000 2017,@wouterhuijs Looks like Tues/Wed for 8.1 release,227,33,260,2017-03-23
3117,844360665900838912,Wed Mar 22 01:30:44 +0000 2017,@karaswisher I am not. This bill changes almost nothing about what NASA is doing. Existing programs stay in place a‚Ä¶ https://t.co/RXn1LlD6qa,1076,394,1470,2017-03-22
3119,843504884154417153,Sun Mar 19 16:50:10 +0000 2017,RT @SpaceX: Recovery teams en route to Dragon. https://t.co/5aiGcX0vS2,0,3564,3564,2017-03-19
3120,842447592172675072,Thu Mar 16 18:48:52 +0000 2017,RT @SpaceX: More photos from today's Falcon 9 launch ‚Üí https://t.co/095WHWMtKp https://t.co/O2RkVlZnak,0,5060,5060,2017-03-16
3127,841563925707546626,Tue Mar 14 08:17:30 +0000 2017,"Finally, an explanation for daylight savings that makes sense ... https://t.co/kGpJHNgRJO",15780,4961,20741,2017-03-14
3128,841098180573851648,Mon Mar 13 01:26:47 +0000 2017,@AndreElijah Ok,713,92,805,2017-03-13
3133,841039231694786560,Sun Mar 12 21:32:33 +0000 2017,"Just wanted to write a note of appreciation to the many Australians who came out in support of the battery plan, especially @mcannonbrookes",11485,1625,13110,2017-03-12
3139,840410357122314240,Sat Mar 11 03:53:37 +0000 2017,"@mcannonbrookes Just spoke with @JayWeatherill, Premier of South Australia. Very impressed. Govt is clearly committ‚Ä¶ https://t.co/JNOCwKVMxY",3737,1406,5143,2017-03-11
3142,840032197637685249,Fri Mar 10 02:50:57 +0000 2017,@mcannonbrookes Tesla will get the system installed and working 100 days from contract signature or it is free. That serious enough for you?,16158,6741,22899,2017-03-10
3146,838558471972741120,Mon Mar 06 01:14:54 +0000 2017,https://t.co/3YSXZq1EVj,24229,3784,28013,2017-03-06
3148,837113202030759937,Thu Mar 02 01:31:54 +0000 2017,Thank you for the lovely letter. That sounds like a great idea. We'll do it! https://t.co/ss2WmkOGyk,38762,9107,47869,2017-03-02
3149,836443541001797632,Tue Feb 28 05:10:55 +0000 2017,SpaceX could not do this without NASA. Can't express enough appreciation. https://t.co/uQpI60zAV7,25829,4457,30286,2017-02-28
3151,836328719165763584,Mon Feb 27 21:34:39 +0000 2017,"Fly me to the moon ... Ok
https://t.co/6QT8m5SHwn",54592,29386,83978,2017-02-27
3155,835350234049863680,Sat Feb 25 04:46:30 +0000 2017,Roller coasters are awesome,32322,6978,39300,2017-02-25
3156,835202594968477696,Fri Feb 24 18:59:50 +0000 2017,@johnpaulbrewer Something on a tristate border might work. Gigafactory plus nearby supporting supply chain needs a very large workforce.,482,48,530,2017-02-24
3161,834740218531962881,Thu Feb 23 12:22:31 +0000 2017,Excellent Tesla Model X review https://t.co/wvog4Pbo1o,3939,891,4830,2017-02-23
3163,833332384913252352,Sun Feb 19 15:08:17 +0000 2017,https://t.co/6Ve3YJoStm,104111,27725,131836,2017-02-19
3174,832970849791537152,Sat Feb 18 15:11:41 +0000 2017,"All systems go, except the movement trace of an upper stage engine steering hydraulic piston was slightly odd. Standing down to investigate.",8567,1687,10254,2017-02-18
3181,832647116816150530,Fri Feb 17 17:45:17 +0000 2017,"Investigating a (very small) leak in the upper stage. If ok, will launch tomorrow. https://t.co/bQf97lywn4",7410,1651,9061,2017-02-17
3191,832084402473627650,Thu Feb 16 04:29:15 +0000 2017,"Apparently, there is this thing called ""Dad jokes"" and I make them",25643,4951,30594,2017-02-16
3194,831972613912080384,Wed Feb 15 21:05:03 +0000 2017,"In appreciation, Tesla is providing all repair costs free of charge and expedited. https://t.co/D68HNJcCoQ",51724,15420,67144,2017-02-15
3197,830239445433544704,Sat Feb 11 02:18:03 +0000 2017,@SEACityLight @Nas2four Sounds like the Tesla Powerwall (consumer) and Powerpack (utility/commercial) might be useful,774,91,865,2017-02-11
3198,830148763578662916,Fri Feb 10 20:17:43 +0000 2017,Falcon 9 rocket now vertical at Cape Canaveral on launch complex 39-A. This is the same launch‚Ä¶ https://t.co/wY6dWRcer3,9904,2157,12061,2017-02-10
3201,829834118733062144,Thu Feb 09 23:27:26 +0000 2017,RT @TeslaMotors: Supercharger availability is now displayed on your Tesla touchscreen so you can see how many stalls are open before you ar‚Ä¶,0,1550,1550,2017-02-09
3207,829396254920568832,Wed Feb 08 18:27:31 +0000 2017,George Schultz and Jim Baker article in @WSJ regarding a carbon tax https://t.co/tf2Urgms85,3488,1453,4941,2017-02-08
3216,828981873086865410,Tue Feb 07 15:00:54 +0000 2017,Production Tesla Model S P100DL sets Motor Trend all-time world record to 60 mph in 2.27 sec https://t.co/sxALQrM5Ls,20737,7788,28525,2017-02-07
3218,828320620463140865,Sun Feb 05 19:13:20 +0000 2017,Signing off now. That was more than enough Twitter trouble for one morning!,7061,359,7420,2017-02-05
